GGTAGCGTCGGTGCGCTCCCTTTTATCTTCTCGGAAAGCCCGAACCTCACGATTACCGATGCGTTTTTTGAATCTTTCTCT	['TATCTT', 'CTTTTA', 'TTTTA', 'TTTTAT', 'TTTTT', 'TTTT', 'TTTTTT', 'CTTTT', 'CCTTTT', 'CCCTTT', 'TCCCTT', 'GTTTTT', 'TTTTTG']
CAGCTGGTGTAAGTAAATTCTATCAACGAAGATCAATCTTATCTACTGACCAAAAAGGCCTGATAGGGCTTCGCTCACTAT	['ATCTTA', 'ATTCTA', 'ATAGG', 'TGTAA', 'ATAG', 'TGTAAG', 'TAAGTA', 'AAGTAA', 'TAAAT', 'TAAATT']
TGCCTTATCTGCCTGTCATCATTCACACTCAACAAGAGGCGATGATTTCAGGCTGCAATGGTTTTTATTTTGGCAACGAGT	['TCACA', 'ATTTCA', 'TTCACA', 'ATTTT', 'TTTTA', 'TATTTT', 'TTTTAT', 'TTATTT', 'TTTTTA', 'TTTCAG', 'TTTTT', 'TTTT', 'GTTTTT']
TTCAGCTGAATGATTGCGATACCAATGTTGCATCTAAAGCCGCTGTTGCCTTTTTAGGTACGGCGATTGATGCGGGTCATA	['TCATA', 'ATCTAA', 'TTTAG', 'TTTAGG', 'TTTTAG', 'TTTTA', 'TTTTTA', 'TTGCAT', 'TTTTT', 'TTTT', 'CTTTT', 'CCTTTT', 'CTTTTT']
GAATTAGGCGTTAACCAGGATAAGCACCTGATTGTCTATGACGAAGGTAATCTTTTCTCAGCCCCACGAGCATGGTGGATG	['AATTAG', 'AATTA', 'ATAA', 'TAAT', 'TTTT', 'CTTTT', 'TCTTTT', 'CTTTTC', 'TTTTCT', 'CCCCAC']
GCCCGCCGCTGGCGGGTAGAAATCATGAGCGCCAGCGAGGGTGAACATGGTGGTTATAAAGAGATCATCGCCAAAATTAGC	['AATCAT', 'GTTATA', 'AATTAG', 'TTATA', 'AATTA', 'TATAA', 'ATAA', 'TATA', 'TATAAA', 'AAAATT', 'TTATAA']
TATGTATGTGTGTGTGTTTGGAGTTGTTTTTTTCTTTTAAATCACCAAATTTTTTTTAAGCTACTTTTTATTTGTGCCTCC	['TAAATC', 'ACTTTT', 'CTTTTA', 'TTTAAG', 'ATGTAT', 'TAAAT', 'ATTTT', 'AATTT', 'TTTTA', 'TTAAAT', 'AAATTT', 'AATTTT', 'TTTTAT', 'TTATTT', 'ATTTTT', 'TTTAAA', 'TTTTAA', 'TTTTTA', 'TTTTT', 'TTTT', 'TTTTTT', 'CTTTT', 'TCTTTT', 'TTTTTC', 'CTTTTT', 'TTTTCT', 'GTTTTT', 'TTGTTT', 'TGTTTT']
GCAGGTCATTTCTTCCCAAGCTGACTCGCTGATTAAAATTTCGCGGATCTGGGCCGATTTTTTTCCCGCAAACACATCGAA	['AATTTC', 'TCATTT', 'ATTTT', 'AATTT', 'TTAAAA', 'AAAATT', 'AAATTT', 'TAAAAT', 'ATTTTT', 'TTTTT', 'TTTT', 'TTTTTT', 'TTTTTC']
AATCAAGGGCTGTTACCTCCGCCAGACGCTGTGCGGGTGGAGGAGATAGTCAATTATTTCCCGTCTGATTGGGATATCAAA	['CAATTA', 'TCAATT', 'ATAGT', 'TAGT', 'ATAG', 'GATAGT', 'AATTA', 'AATTAT', 'TTATTT', 'ATAGTC']
TTCCCGTTCGTCTCTGGCGATATTTTAAGCACAGTAGTGGGTGCATTATTAATCTGCTCGGGTATTGCGCTTATTGTCGGG	['TAGT', 'TTTAAG', 'ATTTT', 'TTTTA', 'TTAAT', 'TAAT', 'ATATTT', 'TATTTT', 'ATTAAT', 'TATTAA', 'ATTTTA', 'TTATTA', 'TTTTAA', 'TTTT']
GAACAATTCGCCAAAATGAAATCCTCCGCCATTTTCATTAATGCCGGACGTGGCCCGGTGGTTGACGAAAATGCACTGATC	['ACAAT', 'ACAATT', 'AACAAT', 'TTTCAT', 'TTTTCA', 'TTCATT', 'AAATGA', 'ATTTT', 'TTAAT', 'TAAT', 'ATTAAT', 'TTTT']
CCACTTTACGTTACGCATGGGTCAGAGAATATACCAAAAATAGAAAGCGGCATTACCATTTGATACTGTGTTTCAATCAGG	['ATACT', 'TATAC', 'ATATAC', 'AATAG', 'ATAGA', 'ATAG', 'ATAGAA', 'AGAATA', 'AATAGA', 'AAATAG', 'ATATA', 'AAATA', 'TATA', 'AATATA', 'AAAATA', 'ATACTG']
TCAGCAGGGTGGGGAAGCAATAGTTATCAGAACTATGATGTCTCTACGCAGCAACAACTGGGGGATAAGACACGGGTAACG	['AATAG', 'ATAGT', 'TAGTT', 'TAGT', 'ATAG', 'AATAGT', 'ATAGTT', 'TATGAT', 'ATAAGA', 'TAGTTA', 'ATAA', 'CAATAG']
GTGGATCAGACCAGTTTAAAAGAGCGGCATATCACTGGGCTGCATTACAACCCGATCACTAATACTTTTAAACTCGGCCCC	['ACTAA', 'ATACT', 'CTAATA', 'ATACTT', 'ACTTTT', 'CTTTTA', 'ACTAAT', 'TAATA', 'TTTTA', 'TAAT', 'TTAAAA', 'TTTAAA', 'TTTTAA', 'TTTT', 'CTTTT']
ATTTAAATACACCACGTTTCCTCCTGTGCCGTATTTGTGCCATTGTAACCTTGGCAATTCATCAAAATACTGTTCTGACAT	['ATACA', 'ATACT', 'ATTCAT', 'AATACA', 'TGTAA', 'TTGTAA', 'TAAAT', 'ATTTA', 'AAATA', 'TTAAAT', 'TAAATA', 'AAAATA', 'ATTTAA', 'TTTAAA', 'ATACTG']
GAGTATCTGAATGGACATATTCCCGGCGCAGTGTTTTTTGATATCGAAGCGCTTTCTGATCACACTTCCCCGCTTCCGCAC	['TCACA', 'ACATA', 'ACATAT', 'ACACTT', 'ATCACA', 'GACATA', 'TTTTT', 'TTTT', 'TTTTTT', 'GTTTTT', 'TGTTTT', 'TTTTTG']
ATGAACTACATAATACATCACAATTTATTATAGATAATATCCTTCAAACGGTACATAAACCAGAACGATCTGTAAGATTAG	['CATAA', 'ACAAT', 'TCACA', 'ATACA', 'ACATA', 'ACATAA', 'ACAATT', 'CATAAA', 'CATAAT', 'CAATTT', 'TCACAA', 'TACATA', 'ATACAT', 'ATCACA', 'AATACA', 'TAGAT', 'ATAGA', 'TATAG', 'TGTAA', 'ATAG', 'TAAGAT', 'TGTAAG', 'TTATAG', 'GATAAT', 'ATAGAT', 'TATAGA', 'TAATA', 'ATTTA', 'AATTT', 'ATAAT', 'TTATA', 'ATAA', 'TAAT', 'TATA', 'TAATAT', 'TATTAT', 'AATTTA', 'ATTATA', 'ATAATA', 'TTATTA', 'CTGTAA']
TTCCTTACGAGCAGGCCACACTGCTGGAGAAAAACAAAAATATCGAGTTGATGGCCAGTCCGTCAATTATGCAGCGTTATA	['CAATTA', 'TCAATT', 'GTTATA', 'TTATA', 'AATTA', 'AAATA', 'TATA', 'AAAATA', 'AATTAT', 'AAATAT']
GCTGATTGGTTCATTGTCGCCATCACCGCTGGACGGTGTATTAAGTAAAGCGTCAACGCTGGAGATTTTTCATCAGGAACT	['TTTCAT', 'TTTTCA', 'TTCATT', 'TAAGTA', 'AAGTAA', 'ATTTT', 'TATTAA', 'ATTTTT', 'TTTTT', 'TTTT', 'TTTTTC']
TAAAACCTTTTTCATTTTCTGAGTTGCTGGCAAGGGTTCGGGCACAATTAAGGCAACATCACGCTTTGAATTCAACATTAG	['ACAAT', 'ACAATT', 'CAATTA', 'TTTCAT', 'TCATTT', 'TTTTCA', 'TTCATT', 'TAAGG', 'TTAAGG', 'ATTTT', 'AATTA', 'AATTAA', 'TTTTT', 'TTTT', 'CTTTT', 'CCTTTT', 'TTTTTC', 'CTTTTT', 'TTTTCT']
TAATAGTCTTTTTAATATGTGACAATAGTGTTGCTAAGGTGTGATTGAAGCGTGGAGTTTACGCACGTTGAGTGATCACCT	['ACAAT', 'ACAATA', 'AATAG', 'ATAGT', 'TAAGG', 'TAGT', 'ATAG', 'AATAGT', 'TAAGGT', 'TAATAG', 'TAGTGT', 'ATAGTG', 'TAATA', 'TTTTA', 'TTAAT', 'TAAT', 'TAATAT', 'TTTAAT', 'TTTTAA', 'TTTTTA', 'TTAATA', 'CTAAGG', 'CAATAG', 'ATAGTC', 'TTTTT', 'TTTT', 'CTTTT', 'TCTTTT', 'CTTTTT']
GCGTTTAGCCCGGATGCGAAAGTCGGCTTCCTGGCCATTGCTAATAAGTTCCAGGCAATGATCGACAGCGGCAATATTCCG	['CTAATA', 'TTTAG', 'AATAAG', 'ATAAGT', 'AATAA', 'TAATA', 'ATAA', 'TAAT', 'AATATT', 'TAATAA']
GTTTTTAACCAGACAACAAGTATATGAATTATCGGAGGTTGTCGATCAACTCGATATACCCGTACTTTGTTATGGTTTACG	['TATAC', 'ATATAC', 'GTATA', 'TGTTAT', 'TTGTTA', 'GATATA', 'AGTATA', 'ATATA', 'TTTTA', 'AATTA', 'TATAT', 'TATA', 'AATTAT', 'TTTTAA', 'TTTTTA', 'TTTTT', 'TTTT', 'GTTTTT', 'TTTGTT']
CAAGGTAATTTGTTGCCTCAATCCAAAATTGCCCGGTTAAAAACAGGCATGAGTAAGAATGACGTTGCAATCTTAATGGGT	['ATCTTA', 'CTTAAT', 'TCTTAA', 'GTAATT', 'GAGTAA', 'TAATT', 'AATTT', 'TTAAT', 'TAAT', 'TTAAAA', 'AAAATT', 'TAAAAA', 'TAATTT', 'TTTGTT']
TAGCCCATGAATAACAATCAGAAAGGACCATAACAGACCCGTTAAAATGAAATATAAGAGACGGTCAACGGGTGAAGAAAA	['CATAA', 'TAACA', 'ACAAT', 'ATAACA', 'CATAAC', 'AACAAT', 'AATAAC', 'TAACAA', 'CCATAA', 'AAATGA', 'TATAAG', 'GAATAA', 'TAAGAG', 'ATAAGA', 'AATAA', 'ATATA', 'AAATA', 'TATAA', 'ATAA', 'TATA', 'AATATA', 'ATATAA', 'TTAAAA', 'TAAAAT', 'AAATAT']
AGTTTAAACGCTACTACCGTTCCGTAGATGCACTGCTGATCGACGATATTCAGTTTTTTGCTAATAAAGAACGATCTCAGG	['CTAATA', 'TAGAT', 'AATAA', 'TAATA', 'ATAA', 'TAAT', 'TAATAA', 'TTTAAA', 'AATAAA', 'TTTTT', 'TTTT', 'TTTTTT', 'GTTTTT', 'TTTTTG']
AGAAAGTCAGGAGTGGATTGAAGATAAATATAAGGATAAATCAACATTTTTGTCTGTCTTCAGAAAACCACATCTTTCAAT	['TAAATC', 'ACATTT', 'TAAGG', 'TATAAG', 'TAAGGA', 'ATATA', 'TAAAT', 'ATTTT', 'AAATA', 'TATAA', 'ATAA', 'TATA', 'AATATA', 'ATATAA', 'TAAATA', 'ATAAAT', 'ATTTTT', 'AAATAT', 'TTTTT', 'TTTT', 'TTTTGT', 'TTTTTG']
AATAATGACATTGCTGAAAAAATGTTCATCAGCAACAAAACTGTCAGCACTTATAAAAGTCGCCTGATGGAAAAATTAGAA	['ACTTA', 'CTTATA', 'TTAGA', 'ATTAGA', 'ATAATG', 'AATTAG', 'AATAA', 'ATAAT', 'TTATA', 'AATTA', 'TATAA', 'ATAA', 'TAAT', 'TATA', 'TATAAA', 'AAAATT', 'ATAAAA', 'TTATAA', 'AATAAT']
CAAAGCCTGAAAGATGAATTTAAGTCGATGAAAATCACGGTGAACTGGGAAAAAGCCTGGCCTGCCGTTTTTATCGCTTTC	['TTTAAG', 'ATTTA', 'AATTT', 'TTTTA', 'AATTTA', 'TTTTAT', 'ATTTAA', 'TTTTTA', 'TTTTT', 'TTTT', 'GTTTTT']
CACTATAAATCTCGCGTTCACTCAACTTACGGCAACGTTGATGTGCTGAAAGCGGCTTGCCGTCAGGAAATGTGGATCAAC	['ACTTA', 'CTATA', 'CTATAA', 'TAAATC', 'AACTTA', 'TAAAT', 'TATAA', 'ATAA', 'TATA', 'TATAAA', 'ATAAAT']
CACCGACATAACGTGCGTCTGCGTATTATTGGCGATACCAGTCGCTTTAACTCGCGTTTGCAAGAACGTATTCGTAAATCT	['CATAA', 'ACATA', 'ACATAA', 'CATAAC', 'TAAATC', 'TTAACT', 'TAAAT', 'ATAA', 'TATTAT', 'GACATA']
AGCGGCCCCCGCAGCTTCGGATAAACCACGAGAAAATAGCGAGTCGCTGCTTAACCGTTTTTTCCTCAGCCGTGTTGTTAT	['AATAG', 'ATAG', 'TGTTAT', 'TTGTTA', 'AAATAG', 'AAATA', 'ATAA', 'AAAATA', 'AATAGC', 'CCCCC', 'TTTTT', 'TTTT', 'TTTTTT', 'TTTTTC', 'GTTTTT', 'CCCCCG']
CATGGCCTCTATCTGTTATATGACCGGCGAAATTAAAAACCCCGGAAAAACCATGCCACGAGCGCTGATTGGTTCCTGTCT	['TGTTAT', 'GTTATA', 'TTATA', 'AATTA', 'TATAT', 'TATA', 'TTAAAA', 'TTATAT', 'TAAAAA', 'AATTAA']
ATCTATTTTCCTGAAACAAGGTGAATATTCAAAAACTCCTGTCAAATTGCCTTTTGCCCTGAAAAATGCATAGTCAAATAT	['CAAATA', 'TCAAAT', 'ATAGT', 'TAGT', 'ATAG', 'ATTTT', 'AAATA', 'AATATT', 'TATTTT', 'AAATAT', 'CATAG', 'ATAGTC', 'GCATAG', 'CATAGT', 'TTTT', 'CTTTT', 'CCTTTT']
TTTCAGCAATATATTGAATTTACGTGCTTTTGTTGGCCGGACAAAGCGTTTACGCCGCATCCGGCATGAACAAAGCACACG	['ATATA', 'ATTTA', 'AATTT', 'TATAT', 'TATA', 'AATATA', 'TATATT', 'AATTTA', 'ATATAT', 'TTTCAG', 'TTTT', 'CTTTT', 'TTTTGT', 'TTTGTT']
GTTAGAGTCATTACCGTTTCGTCTATATAAAAACTTATGTTTTTGGTACATTAGCAGTATATATCATCTCTATCATCACAA	['ACTTA', 'TCACA', 'CTATA', 'TATCAT', 'TCACAA', 'ATCACA', 'AACTTA', 'TTAGA', 'GTATA', 'AGTATA', 'TAGAGT', 'GTTAGA', 'ATATA', 'TATAA', 'TATAT', 'ATAA', 'TATA', 'TATAAA', 'ATATAA', 'TATATA', 'TAAAAA', 'ATAAAA', 'ATATAT', 'TTAGCA', 'TTTTT', 'TTTT', 'GTTTTT', 'TGTTTT', 'TTTTTG']
TGGCGGGAGCAATCTGGCGGTCAGTAACCCTGAGCTGGATAAACTAATAGCCGCACGCGTTGCTGCATTACGGGCCGCTAA	['ACTAA', 'CTAATA', 'AAACTA', 'AACTAA', 'ACTAAT', 'AATAG', 'ATAG', 'TAATAG', 'TAATA', 'ATAA', 'TAAT', 'AATAGC']
TACAGTGCATAATGTGACATTTGGAATGCTTATCAACTGCATGTAAACATTAATAACCTGCACTTTTTTGTCTTAAGGTTT	['CATAA', 'CATAAT', 'ACTTTT', 'ACATTT', 'TCTTAA', 'AATAAC', 'TGTAA', 'TAAGG', 'TAATGT', 'TGTAAA', 'TAAGGT', 'ATAATG', 'ATGTAA', 'TTAAGG', 'AATAA', 'TAATA', 'ATAAT', 'TTAAT', 'ATAA', 'TAAT', 'ATTAAT', 'TAATAA', 'TTAATA', 'TTTTT', 'TTTT', 'TTTTTT', 'CTTTT', 'CTTTTT', 'TTTTGT', 'TTTTTG']
GCAGTGCCATTTATGATAAAAACATCCCTTAAAACCAATCTAATCTTTTTCTTCCTCTGTGTATTTGTTCCCCATATGGCG	['ATCTAA', 'CTTAAA', 'TCTAAT', 'ATGATA', 'TATGAT', 'ATTTA', 'ATAA', 'TAAT', 'TTAAAA', 'TAAAAA', 'ATAAAA', 'TTTTT', 'TTTT', 'CTTTT', 'TCTTTT', 'TCCCTT', 'TTTTTC', 'CTTTTT', 'TTTTCT', 'TTTGTT']
GTTCATAACCAGCCGGGGTTATATGTTGGTCAACAAGCGCGCTTTGGTGGGAAGGTTATCAACGTTATCAATGGCAAAACG	['TCATA', 'CATAA', 'TCATAA', 'CATAAC', 'TTCATA', 'GTTATA', 'TTATA', 'TATAT', 'ATAA', 'TATA', 'TTATAT']
GCAAAGCTTGGTTGTTGTTAAAGATGAATTTTTTAACGGACTCGATGCCGTCATAAAAGTGATATTTAACGGCTACGCTGA	['TCATA', 'CATAA', 'TCATAA', 'CATAAA', 'TTGTTA', 'ATTTA', 'ATTTT', 'AATTT', 'TTTTA', 'ATAA', 'ATATTT', 'TATTTA', 'AATTTT', 'ATTTAA', 'ATTTTT', 'ATAAAA', 'TTTTAA', 'TTTTTA', 'TTTTT', 'TTTT', 'TTTTTT']
ACGCTTAGGCGTGTGACTGCGTACCTTTTGTATAATGGGTCAGCGACTTATATTCTGTAGCAAGGTTAACCGAATAGGGGA	['ACTTA', 'CTTATA', 'AATAG', 'ATAGG', 'GTATA', 'ATAG', 'GAATAG', 'GTATAA', 'AATAGG', 'TGTATA', 'ATAATG', 'ATAAT', 'TTATA', 'TATAA', 'TATAT', 'ATAA', 'TAAT', 'TATA', 'TATAAT', 'TTATAT', 'TATATT', 'TAGCAA', 'TTTT', 'CTTTT', 'CCTTTT', 'TTTTGT']
TTATATTCAGCATGATATCAGCGCATGGACGATGGCAGAGGCCTTGTTTGGTGCCTCACGCGGGGCGCGCGATGTGATTCA	['ATGATA', 'TTATA', 'TATAT', 'TATA', 'TTATAT', 'TATATT', 'CTTGT', 'CCTTGT', 'CTTGTT', 'TTGTTT']
TTAATTCAATACGTCGTGAATGAATGTATTGCGGCTGGCATTACTGAAATTGTGCTGGTTACACACTCATCTAAAAACTCT	['ACTCAT', 'ATCTAA', 'TAATTC', 'AATTGT', 'ATGTAT', 'AATGTA', 'TAATT', 'TTAAT', 'TAAT', 'TAAAAA', 'TTAATT']
ACACTCAATAATCTTCATACCGGAGAGTCAATCAAAGCGGAGTTTTTCGATGGCAGAGGCTATATTCAGGAAGAATTGGCA	['TCATA', 'CTATA', 'CAATAA', 'ATAATC', 'TTCATA', 'AGAATT', 'AATAA', 'ATAAT', 'TATAT', 'ATAA', 'TAAT', 'TATA', 'TATATT', 'AATAAT', 'GCTATA', 'TTTTT', 'TTTT', 'TTTTTC', 'GTTTTT']
AATCAGCGTTGGTAAAGTTTTTGCTAACGCAGATGAGTGGATGACAACGTTTAGAGAAAATATTGCACAAACCTGGCAACA	['TTAGA', 'TTTAG', 'TTTAGA', 'TAGAGA', 'AAATA', 'AAAATA', 'AATATT', 'AAATAT', 'TTTTT', 'TTTT', 'GTTTTT', 'TTTTTG']
CTGGTGTCCTCCAAACTGAAATTGTTTGTAACGATAGTCTTTTACAGGTTTTCCTTTAAAGATGTTTGTGTGCTTTTAATT	['TTTACA', 'CTTTTA', 'ATAGT', 'TGTAA', 'TAGT', 'ATAG', 'GATAGT', 'AATTGT', 'TTGTAA', 'TAATT', 'TTTTA', 'TTAAT', 'TAAT', 'TTTAAA', 'TTTAAT', 'TTTTAA', 'TTAATT', 'ATAGTC', 'TTTT', 'CTTTT', 'TCTTTT', 'TTGTTT']
GCGTGATGGGACTGTGCCAACCAATGATGGCTACCTATCGTCCACATAATAATCAGCTGATGGAATGGGTGCAGACCCGTG	['CATAA', 'ACATA', 'ACATAA', 'CACATA', 'CATAAT', 'TAATCA', 'ATAATC', 'AATAA', 'TAATA', 'ATAAT', 'ATAA', 'TAAT', 'ATAATA', 'TAATAA', 'AATAAT']
ACGTTATCGTTATTGCGGCACCGATGTATAACTTCAACATCTCGACTCAGTTGAAAAACTATTTTGACCTGGTTGCCCGCG	['AAACTA', 'GTATA', 'GTATAA', 'TGTATA', 'ATGTAT', 'ATTTT', 'TATAA', 'ATAA', 'TATA', 'TATTTT', 'TTTT']
TTAGTGCCAACTTCGCTGCGAGTGGCTTTTTTCACTGTGGTTGAACAAGTATTGGCGAAGGTTAATACCCTTTGGGCCCAG	['TTTTCA', 'TTAGT', 'TAGT', 'TAATA', 'TTAAT', 'TAAT', 'TTAATA', 'TTTTT', 'TTTT', 'TTTTTT', 'CTTTT', 'CCCTTT', 'TTTTTC', 'CTTTTT']
CAAAATAGGAATTGATAATCAAATCTGTCACTATTGCGCCTCTAACAGATTCATCGTGCTGTACCCTACATACAGCCGAAC	['TAACA', 'ATACA', 'ACATA', 'ATTCAT', 'ACATAC', 'TAATCA', 'TCAAAT', 'TACATA', 'ATAATC', 'AATAG', 'ATAGG', 'ATAG', 'ATAGGA', 'GATAAT', 'TAGGAA', 'AATAGG', 'AAATAG', 'ATAAT', 'AAATA', 'ATAA', 'TAAT', 'AAAATA', 'ATACAG']
GAGTTTGTTATTGACGTGTTACAAAAATTCTTTTCTTATGATGTAGAACGTGCAACGCAATTGATGCTCGCTGTTCACTAC	['TTCTTA', 'TGTTAT', 'TTGTTA', 'TATGAT', 'AAAATT', 'TTTT', 'CTTTT', 'TCTTTT', 'CTTTTC', 'TTTTCT', 'TTTGTT']
TGGCAGAGCGATACAAGCTGGTGCTAACGGTTTTGTCAGTAAATGCAATGATCAGAATGATATTTTTCATGCCGTTCAGAT	['ATACA', 'TTTCAT', 'ATACAA', 'TTTTCA', 'ATGATA', 'TAAAT', 'ATTTT', 'ATATTT', 'TATTTT', 'ATTTTT', 'TTGTCA', 'GATACA', 'TTTTT', 'TTTT', 'TTTTTC', 'TTTTGT']
TATTAGTTCGGCGTAAGAACTCAGAGACTTAATTCCCCTATCCCATAGATAACGATAGGGGAAAATTATTTTTGCAGAATT	['ACTTA', 'ACTTAA', 'CCCCTA', 'CTTAAT', 'TAATTC', 'CCCTAT', 'TTAGT', 'TAGAT', 'ATAGG', 'ATAGA', 'TAGTT', 'TAGT', 'ATAG', 'TTAGTT', 'ATAGAT', 'AGAATT', 'TAATT', 'ATTTT', 'AATTA', 'TTAAT', 'ATAA', 'TAAT', 'AAAATT', 'AATTAT', 'TATTTT', 'TTATTT', 'ATTTTT', 'TTAATT', 'CATAG', 'CATAGA', 'TAGTTC', 'TTTTT', 'TTTT', 'TCCCCT', 'TTTTTG']
CCCGGCATTGCCATTCCTCCGTCATTATTGAATATGTATAAAGAGCTGGAAAATACTATTCCGGGCTTCACCCGCCCTAAT	['ATACT', 'ATACTA', 'CCTAAT', 'GTATA', 'GTATAA', 'TGTATA', 'ATGTAT', 'AAATA', 'TATAA', 'ATAA', 'TAAT', 'TATA', 'TATAAA', 'AAAATA', 'GCCCTA']
ATCAGGCCTAAAGGGATTTCTAACTCATTGATAAATTTGTTTTTGTAGGTCGGATAAGGCGTTCACGCCGCATCCGACATT	['ACTCAT', 'CCTAAA', 'TAAGG', 'TAAAT', 'AATTT', 'ATAA', 'ATAAAT', 'AAATTT', 'TAAATT', 'TTTTT', 'TTTT', 'GTTTTT', 'TTTTGT', 'TTGTTT', 'TTTGTT', 'TGTTTT', 'TTTTTG']
GGTTTCTATTGTGGTGACGTCTTGCTGTGGATTATTTTTCGGTGATGTTCATTTTAGCGGCGTCTATTCCATTCCGCCTGA	['TCATTT', 'TTCATT', 'TTTAG', 'TTTTAG', 'ATTTT', 'TTTTA', 'TATTTT', 'TTATTT', 'ATTTTA', 'ATTTTT', 'TTTTT', 'TTTT', 'TTTTTC']
TTTTGCCCACCTGGCTCGCCGCACCTTAAAATACGACAGATAAAATTATAGGCAGCCATAAAAATAGTGATCTCAAAACGT	['CATAA', 'CATAAA', 'CTTAAA', 'CCATAA', 'AATAG', 'ATAGT', 'ATAGG', 'TATAG', 'TAGT', 'ATAG', 'TTATAG', 'AATAGT', 'ATAGTG', 'AAATAG', 'TATAGG', 'TTATA', 'AATTA', 'AAATA', 'ATAA', 'TATA', 'TTAAAA', 'AAAATA', 'AAAATT', 'AATTAT', 'ATTATA', 'TAAAAA', 'TAAAAT', 'ATAAAA', 'ATAGGC', 'TTTT']
AATGGGTCAGGACGCTTTTAATCACATATAAAAAGCGTCCTTTTTCTCACAATCAAATGATCATCGGCTTCTATAACGAAA	['ACAAT', 'TCACA', 'CTATA', 'ACATA', 'ACATAT', 'CTATAA', 'CACATA', 'CATATA', 'TCACAT', 'TCACAA', 'TAATCA', 'TCAAAT', 'CTTTTA', 'ATCACA', 'AAATGA', 'ATATA', 'TTTTA', 'TTAAT', 'TATAA', 'ATAA', 'TAAT', 'TATA', 'TATAAA', 'ATATAA', 'TAAAAA', 'ATAAAA', 'TTTAAT', 'TTTTAA', 'TTTTT', 'TTTT', 'CTTTT', 'CCTTTT', 'TTTTTC', 'CTTTTT', 'TTTTCT']
ACGATGATTGATACCAACAACAAAGGCCTGGTATATATGACGCGCGCCGTCTTACCGGGTATGGTTGAACGTAATCATGGT	['AATCAT', 'TAATCA', 'GTATA', 'GGTATA', 'ATATA', 'TATAT', 'TAAT', 'TATA', 'TATATA', 'ATATAT']
AGCTCCGCTGTGAGCGCAGGCTGTGTTAAAACTCCTGATCACTTTTTGGTCTAAGCGATGGTTTCATATGATCAACCATTC	['TCATA', 'TTTCAT', 'ACTTTT', 'TTCATA', 'TGTGAG', 'TATGAT', 'TTAAAA', 'TTTTT', 'TTTT', 'CTTTT', 'CTTTTT', 'TTTTTG']
CGCGGTTTTCCTGATTTTAAACTTCATCTGGCACAGAGTCTGGCGAATGGCACTCCCTATGTTAATCGCAATGTCAATGAA	['CCCTAT', 'ATGTTA', 'ATTTT', 'TTTTA', 'TTAAT', 'TAAT', 'ATTTTA', 'TTTAAA', 'TTTTAA', 'TTTT']
AACCGCAACGGCAAGTCATGGCTGATGGCGGTGGTTGGTGCGGAATATATTTTGCGCATGGTGCCCAAAGGCACGCATGAT	['ATATA', 'ATTTT', 'TATAT', 'TATA', 'AATATA', 'ATATTT', 'TATTTT', 'TATATT', 'ATATAT', 'TTTT']
CAGTATTTAGGCACTCGCTATGATAAGGATTACTCATCTTATCCTTATCAAACCGTTAAAATGGGCGGTGTGAGCTTGTGG	['ACTCAT', 'ATCTTA', 'TTTAG', 'TAAGG', 'ATGATA', 'TTTAGG', 'ATTTAG', 'TGTGAG', 'TATGAT', 'TAAGGA', 'ATTTA', 'ATAA', 'TTAAAA', 'TATTTA', 'TAAAAT', 'CTTGT']
TGGGCGATATTTTCCGCTGGGGAGAGGCATTAATTCAGGTCAGCCAGCCGCGCTCGCCTTGCTATAAACTCAATTACCATT	['CTATA', 'CTATAA', 'CAATTA', 'TAATTC', 'TCAATT', 'TAATT', 'ATTTT', 'AATTA', 'TTAAT', 'TATAA', 'ATAA', 'TAAT', 'TATA', 'TATAAA', 'ATATTT', 'TATTTT', 'ATTAAT', 'TTAATT', 'GCTATA', 'TTTT']
TGGATCGCGCGATTCGCGTGGCTTCCGTGATTATCCACGACGTCGCCAGAAATAATCATTATCGCGTTAACGAACACTTCG	['AATCAT', 'ACACTT', 'TAATCA', 'ATAATC', 'AATAA', 'ATAAT', 'AAATA', 'ATAA', 'TAAT', 'AAATAA', 'AATAAT']
TCCACATTTAAAATTTCGCTGCCGACGCCAATCATGTCCGGCGTGCGTACCCCGACTCGTCAGTTCAGCTCCTGCGTACTG	['AATCAT', 'CACATT', 'AATTTC', 'ACATTT', 'ATTTA', 'AATTT', 'TTAAAA', 'AAAATT', 'AAATTT', 'ATTTAA', 'TAAAAT', 'TTTAAA']
CTCGATATGGAACTACAGCGTGCGACGCGCGGGTTTCATAGCCCACACGCGCCCGATAACCACACCTTTTCCAGCAATGAA	['TCATA', 'TTTCAT', 'TTCATA', 'ATAG', 'ATAA', 'CATAG', 'TCATAG', 'CATAGC', 'TTTT', 'CTTTT', 'CCTTTT', 'CTTTTC']
CAAGGCTAAATACTCCTGACTGACCGATAGTGAACCAGTACCGTGAGGGAAAGGCGAAAAGAACCCCGGCGAGGGGAGTGA	['ATACT', 'ATACTC', 'CTAAAT', 'ATAGT', 'TAGT', 'ATAG', 'GATAGT', 'ATAGTG', 'TAAAT', 'AAATA', 'TAAATA', 'GAGGGA']
ACATGGGGATTGTTTTAGTCAGCGACCGCAATATGCAATCGTTAGCTAATTACTGGCGAAAACACAACTCAGCAATATCTG	['CTAATT', 'TTAGT', 'TTTAG', 'TAGT', 'TTTAGT', 'TTTTAG', 'TAATT', 'TTTTA', 'AATTA', 'TAAT', 'TAATTA', 'TAGCTA', 'TTAGCT', 'TTTT', 'ACACAA', 'TTGTTT', 'TGTTTT']
GCCAAAGTGACTGTTGATGGTCTGCGCGCGGTTAAGCCAATGCGTGAATGGCAACTCTCTGATAATGCTGCTTATATGCAT	['CTTATA', 'GATAAT', 'ATAATG', 'ATAAT', 'TTATA', 'TATAT', 'ATAA', 'TAAT', 'TATA', 'TTATAT']
CTGTGGGACTACGGCATTAGCCGTGGTATCTCGTCAACCGATTGGCATTGATATAGAAGAAATTTTTTCTGTACAAACCGC	['ATAGA', 'TATAG', 'ATAG', 'ATAGAA', 'GATATA', 'TATAGA', 'ATATAG', 'ATATA', 'ATTTT', 'AATTT', 'TATA', 'AAATTT', 'AATTTT', 'ATTTTT', 'TTTTT', 'TTTT', 'TTTTTT', 'TTTTTC', 'TTTTCT']
GATTTTGACTCGGCTCATTATTTGCCCGCTTGAGACATTGTTTCCATATGTACGCGGGCGAATAAATAGAGGAATCTGATT	['AATAG', 'ATAGA', 'ATAG', 'GAATAA', 'ATAGAG', 'AATAGA', 'AAATAG', 'AATAA', 'TAAAT', 'ATTTT', 'AAATA', 'ATAA', 'TAAATA', 'ATAAAT', 'TTATTT', 'AATAAA', 'AGACAT', 'TTTT', 'TTGTTT']
TCTATATCGCGTTATTGATGCCCGCTCAGGCGATTCACTATTTTATGTTGTCGCCCTACAGCGTGGTGATGGACGTTAAAA	['CTATA', 'ATTTT', 'TTTTA', 'TATAT', 'TATA', 'TTAAAA', 'TATTTT', 'TTTTAT', 'ATTTTA', 'GCCCTA', 'TTTT']
AGCATCGCAATCCTTTCCCTGGGTGAGCGATGCTGCCGATGGCGCAGACTTAAGATCCCCGGTCTTACCCGCTATAACCCC	['ACTTA', 'CTATA', 'ACTTAA', 'CTATAA', 'TAAGAT', 'TTAAGA', 'TATAA', 'ATAA', 'TATA', 'GCTATA']
GATATGACCGGCGATGCGGTTGGGCCAAATATGATTAATTTCTGGAAGAATGTCAGTATCGCTGGCGCGTTCTTGCTATTG	['CAAATA', 'AATTTC', 'TATGAT', 'TAATT', 'AATTT', 'TTAAT', 'AAATA', 'TAAT', 'ATTAAT', 'AAATAT', 'TAATTT', 'TTAATT']
TGCGCTAATTTATAAAAACGATCAGCTTTCATGCCTCTTGGGTATGGCTCTTGCTTATAATGTAGCCAGCAACATTATTAC	['CTAATT', 'TTTCAT', 'CTTATA', 'TAATGT', 'ATAATG', 'AATGTA', 'TAATT', 'ATTTA', 'AATTT', 'ATAAT', 'TTATA', 'TATAA', 'ATAA', 'TAAT', 'TATA', 'TATAAT', 'TATAAA', 'TTTATA', 'AATTTA', 'TAAAAA', 'TTATTA', 'ATAAAA', 'TTATAA', 'TAATTT', 'TTGCTT']
TGTCAGGATTATCTCGCGCACCTTGATGGTTTTAATATCGAATGGCTGGCACATGATGAGCAGGCGGTAGATGCGCGTCTG	['TAGAT', 'TAATA', 'TTTTA', 'TTAAT', 'TAAT', 'TAATAT', 'TTTAAT', 'TTTTAA', 'TTAATA', 'TTTT']
TCCTGACGCTGGCGGCAATATATGCGTATCAGGTAAAAGCAGAAGCCGTAATTACTGGCGTCTGCGAAACGGATTTCTCCG	['GTAATT', 'ATATA', 'TAATT', 'AATTA', 'TATAT', 'TAAT', 'TATA', 'AATATA', 'TAATTA', 'ATATAT']
GAGCTGGCAGCAAGGGCCTATCGTTTTGAACTGGTTGGATATACAAGATTCTTTTGATGCTTCTGGTTTTAACCTGATTAT	['ATACA', 'TATAC', 'TATACA', 'ATACAA', 'ATATAC', 'GATATA', 'ATATA', 'TTTTA', 'TATA', 'TTTTAA', 'TTTT', 'CTTTT', 'TCTTTT']
GGATAACGAAGATTTTGTAAAAGCTGTCAAAGCGACAGGTAAAAAACAGTTAATTATTGCCGGTGTGGTAACCGAAGTTTG	['TGTAA', 'TGTAAA', 'TTGTAA', 'TAATT', 'ATTTT', 'AATTA', 'TTAAT', 'ATAA', 'TAAT', 'AATTAT', 'TAAAAA', 'TAATTA', 'TTAATT', 'TTTT', 'TTTTGT']
CAGGCCAGCGCCTTTTTTAGCGGTCGCAGTGCTGTTGCCCCGGTAGATCTCATTTTGCTGAAAGATTGCCTGTGGTATGAC	['TCATTT', 'TAGAT', 'TTTAG', 'TTTTAG', 'ATTTT', 'TTTTA', 'TTTTTA', 'TTTTT', 'TTTT', 'TTTTTT', 'CTTTT', 'CCTTTT', 'CTTTTT']
TGAGCAATCGACGCCGTTTTTTTATAGCTTATTCTTATTAAATTGTCTTAAACCGGACAATAAAAAATCCCGCCGCTGGCG	['ACAAT', 'ACAATA', 'CAATAA', 'CTTAAA', 'TCTTAA', 'TTCTTA', 'TATAG', 'ATAG', 'TTATAG', 'AATTGT', 'AATAA', 'TAAAT', 'TTTTA', 'TTATA', 'ATAA', 'TATA', 'TTTATA', 'TTAAAT', 'TATTAA', 'TTTTAT', 'TAAATT', 'TAAAAA', 'TTATTA', 'ATAAAA', 'AATAAA', 'TTTTTA', 'TTTTT', 'TTTT', 'TTTTTT', 'GTTTTT']
AAGAAACTGGGCGCAGCGGGCGTAGTGGTTGCTGGTTCTGGTGTTCAGGCGATTTTCGGTACTAAATCCGATAACCTGAAA	['ACTAA', 'ACTAAA', 'TAAATC', 'CTAAAT', 'TACTAA', 'TAGT', 'TAAAT', 'ATTTT', 'ATAA', 'TTTT']
AGCCCTGAAAGAGGCAGGTGGTACGCCGGGCGAAAACATGACGATGGATAATAAAGAAACGACTCATGTCACAGGCAGCAA	['TCACA', 'ACTCAT', 'GATAAT', 'AATAA', 'TAATA', 'ATAAT', 'ATAA', 'TAAT', 'ATAATA', 'TAATAA', 'AATAAA']
CCTGTTAGTGATGGTGAAAGCTAACAATAACGATGTGAAAAGCGTGAAAGATCTCGACGGGAAAGTGGTTGCTGTGAAGAG	['TAACA', 'ACAAT', 'ACAATA', 'AACAAT', 'CAATAA', 'AATAAC', 'TAACAA', 'TTAGT', 'TAGT', 'AATAA', 'ATAA']
CGTTTGTTAACGCCCAGGCCGAAGACAGCCAAATCTTTTTATATAAGCGCCGCTATGTTCCGGTAGAAGGCTATGCACCGT	['TATAAG', 'TTGTTA', 'ATATA', 'TTTTA', 'TTATA', 'TATAA', 'TATAT', 'ATAA', 'TATA', 'ATATAA', 'TTTATA', 'TTATAT', 'TATATA', 'TTTTAT', 'TTTTTA', 'TTTTT', 'TTTT', 'CTTTT', 'TCTTTT', 'CTTTTT', 'TTTGTT']
TCGTTTATATGCTAACAAATCGCAAAAATTTGATTATCAGCATGAAGACTGCACAGGACCATCAGCGGATCGATGGCGGCT	['TAACA', 'TAACAA', 'AATTT', 'TTATA', 'TATAT', 'TATA', 'TTTATA', 'AAAATT', 'TTATAT', 'AAATTT', 'ATGCTA']
ACTCGCGCGCACCGGTTAAAACCCCCGCCGACCTGAAAGGGCTGAAAATCCGCACCAACAATAGCCCGATGAATATCGCCG	['ACAAT', 'ACAATA', 'AACAAT', 'AATAG', 'ATAG', 'TTAAAA', 'CAATAG', 'AATAGC', 'CCCCC', 'ACCCCC', 'CCCCCG']
AATCTGGTGAACATCTATAAAGGTCTGTGTATGCCGACGGATCTGCCGCGCTTTTATCTGGATCTTGCGGACCTGCGTCTG	['CTATA', 'CTATAA', 'CTTTTA', 'TTTTA', 'TATAA', 'ATAA', 'TATA', 'TATAAA', 'TTTTAT', 'TTTT', 'CTTTT']
AAATTGCCCGTATCGTGATTATGGGTGGCGCTATGGGGCTGGGTAACTGGACGCCTGCGGCTGAATTTAATATTTACGTTG	['TAATA', 'ATTTA', 'AATTT', 'TTAAT', 'TAAT', 'TAATAT', 'ATATTT', 'AATATT', 'TATTTA', 'AATTTA', 'ATTTAA', 'TTTAAT', 'TTAATA']
GACAAAAACAACGAATTGTTGAACAGGTTCCCTCCCGGCTACGCAAACTTTACCACACCGGTTTTAAATACGAATCTTCGC	['AATTGT', 'TAAAT', 'TTTTA', 'AAATA', 'TTAAAT', 'TAAATA', 'TTTAAA', 'TTTTAA', 'TTTT', 'CCCTCC']
TTGTTTCCTTACAATATTCAAAATTACGCTTACGGATTAACCACAATCGCCTTCTGGCCTTATACCCTTATTTCGGCACTC	['ACAAT', 'TATAC', 'TACAAT', 'ACAATA', 'TTATAC', 'CTTATA', 'TTATA', 'AATTA', 'TATA', 'AAAATT', 'AATATT', 'TTATTT', 'TTGTTT']
ACGATTGCCGGGTTATCAGGGCTGAATAACGCGCGCTTTCAGTTTTTCAACTGGATGAGCGGTCTGCTGTGGGTATTGATC	['AATAAC', 'TTTTCA', 'GAATAA', 'AATAA', 'ATAA', 'TTTCAG', 'TTTTT', 'TTTT', 'TTTTTC', 'GTTTTT']
AAAGCTAAAGCGCCTATTTATTTTGTTAGCCGCAAAGAAAGTATCAAAAATCTTCTTGAGATTACTTATGGTAAACACTTG	['ACTTA', 'TACTTA', 'ACACTT', 'TTGTTA', 'ATTTA', 'ATTTT', 'TATTTA', 'TATTTT', 'TTATTT', 'TTTT', 'TTTTGT', 'TTTGTT']
AATTTAATTATGGCGTGGAAGTCCGCCATCCACAGTTTTTCGCCAAAGGAGAAGAGGAACAAACGCTTAATCGCGGTTTAC	['CTTAAT', 'TAATT', 'ATTTA', 'AATTT', 'AATTA', 'TTAAT', 'TAAT', 'AATTAT', 'AATTTA', 'ATTTAA', 'TAATTA', 'TTTAAT', 'TTAATT', 'TTTTT', 'TTTT', 'TTTTTC', 'GTTTTT']
TTTCTCAGCAGTTAATTAAGAATCTGGCGACACTAAAAGCAGGCAATGCACGCGTGGTGAACAGCAACGCGATGTCATTCC	['ACTAA', 'ACTAAA', 'TTAAGA', 'TAATT', 'AATTA', 'TTAAT', 'TAAT', 'TAATTA', 'AATTAA', 'TTAATT']
AGAAACCACCCCGCGTAATCCAGTAACCAACAGTGGACGAGTATTAGAAGAACTCGAAGACTGGCTGCACAATTTACCCGG	['ACAAT', 'ACAATT', 'CAATTT', 'TTAGA', 'ATTAGA', 'ATTTA', 'AATTT', 'TAAT', 'AATTTA', 'CGAGTA']
TATATTCAGGAAGAATTGGCAAAACTTAACCATTTTTTCCGCGATTACCGCGCGAACAAAATAAAGTCCATCGACCCAGGA	['ACTTA', 'ACTTAA', 'AACTTA', 'AGAATT', 'AATAA', 'ATTTT', 'AAATA', 'TATAT', 'ATAA', 'TATA', 'AAAATA', 'TATATT', 'ATTTTT', 'AAATAA', 'AATAAA', 'TTTTT', 'TTTT', 'TTTTTT', 'TTTTTC']
GCTGTGGTTACTGCATTGCCGGGTGTCCGTTTAATATTCCGCGCCTCAACAAAGAGGATAACCGGGTATATAAATGCACGC	['GTATA', 'GGTATA', 'ATATA', 'TAATA', 'TAAAT', 'TTAAT', 'TATAA', 'TATAT', 'ATAA', 'TAAT', 'TATA', 'TATAAA', 'TAATAT', 'ATATAA', 'ATAAAT', 'AATATT', 'TATATA', 'TTTAAT', 'TTAATA']
ATCGCCGCGCAGAATTTCAGATAATTATCTCCCCGGAGTATCAGGGGAAAGGTCTGGCAACCCGTGCCGCCAAATTAGCAA	['ATTTCA', 'AATTTC', 'GATAAT', 'AGAATT', 'AATTAG', 'TAATT', 'AATTT', 'ATAAT', 'AATTA', 'ATAA', 'TAAT', 'AATTAT', 'ATAATT', 'TAATTA', 'TAGCAA', 'TTTCAG', 'TTAGCA']
TGACTGGGGGGAATCCTTGCTAGTTATATAAGGTCACTGTTAGCTAGAGGCTTGAGCGACAAAAGTGTCATTTGGATTGAG	['TCATTT', 'TAGTT', 'TAAGG', 'TAGT', 'TATAAG', 'GTTATA', 'TAAGGT', 'TAGTTA', 'ATATA', 'TTATA', 'TATAA', 'TATAT', 'ATAA', 'TATA', 'ATATAA', 'TTATAT', 'TATATA', 'CTAGA', 'CTAGTT', 'TAGCTA', 'CTAGAG', 'TTAGCT']
GGCGAAAGACAGAGAAACCCTTTTCTTCACTAGCGTACGGGCAGTCCCTTCAACAACGAAGCGGAAAGAGGGAAATACCCT	['AAATA', 'ACTAG', 'CACTAG', 'ACTAGC', 'TTTT', 'CTTTT', 'CCTTTT', 'CCCTTT', 'TCCCTT', 'CTTTTC', 'TTTTCT', 'GAGGGA']
TCGACGTCGAACAAAATTGTGGGTATGTACGCCGCGCCATCCGGCAGTACGCTGTTGATCGACCGCAATTGTCATAAATCG	['TCATA', 'CATAA', 'TCATAA', 'CATAAA', 'TAAATC', 'AATTGT', 'TAAAT', 'ATAA', 'ATAAAT', 'AAAATT', 'TTGTCA']
GCTGACTCAGTCATTTCATTTCTTCATGTTTGAGCCGATTTTTTCTCCCGTAAATGCCTTGAATCAGCCTATTTAGACCGT	['ATTTCA', 'TTTCAT', 'TCATTT', 'TTCATT', 'TTAGA', 'TTTAG', 'ATTTAG', 'TTTAGA', 'TAAAT', 'ATTTA', 'ATTTT', 'TATTTA', 'ATTTTT', 'TTAGAC', 'TTTTT', 'TTTT', 'TTTTTT', 'TTTTTC', 'TTTTCT']
TGCAACTGGCTCCGGCCAGTGAGGAAGGCGCGACAAAATTAAGCGATAAAATAAATCCACCGGGCGTCGCGCTGGTCACCT	['TAAATC', 'AATAA', 'TAAAT', 'AATTA', 'AAATA', 'ATAA', 'ATAAAT', 'AAAATA', 'AAAATT', 'TAAAAT', 'ATAAAA', 'AATTAA', 'AAATAA', 'AATAAA']
GTATTGTTTCCATTGGTATTTTTAATGGTACTTTATATAGTCTGGTAATGAGTTTTCTCTGGAGTAATACCAGTTTCGGTA	['ATAGT', 'TATAG', 'TAGT', 'ATAG', 'GAGTAA', 'AATGAG', 'TATAGT', 'AGTAAT', 'ATATAG', 'ATATA', 'TAATA', 'ATTTT', 'TTTTA', 'TTATA', 'TTAAT', 'TATAT', 'TAAT', 'TATA', 'TTTATA', 'TTATAT', 'TATTTT', 'TATATA', 'ATTTTT', 'TTTAAT', 'TTTTAA', 'TTTTTA', 'ATAGTC', 'TTTTT', 'TTTT', 'TTTTCT', 'TTGTTT']
TCGGAGCAATTTCGTTCGATGCGACCCAGGCGAAGAGTACGCTAGCAGATCAAAGCGAACATAAAGGTCAGTCATATCGTT	['TCATA', 'CATAA', 'ACATA', 'ACATAA', 'CATAAA', 'CAATTT', 'AATTTC', 'AACATA', 'AATTT', 'ATAA', 'CTAGCA']
CGGTCAGCCGGAGAAAATTCTCGCCCTTGAGATGGGCGGTAATAATCCGCTAATTATCGATGAGGTGGCGGATATCGACGC	['CTAATT', 'ATAATC', 'AATAA', 'TAATA', 'TAATT', 'ATAAT', 'AATTA', 'ATAA', 'TAAT', 'AAAATT', 'AATTAT', 'TAATAA', 'TAATTA', 'AATAAT']
TATTACATGAGTAAGGAAAATACGCTACAACAGGCCGTGGGGTTGCCCGATCAGAAAACGCTTAATATCATTATGGGGAAT	['TATCAT', 'TTACAT', 'CTTAAT', 'TAAGG', 'GAGTAA', 'TAAGGA', 'TAATA', 'TTAAT', 'AAATA', 'TAAT', 'TAATAT', 'AAAATA', 'TTAATA']
CTGGATAAATCCGTTATTTTGAAAACCGCGGATTATTTGCGCATTGCGCAACCAGAACTGGTCAATTTCCGCCGCACTGCG	['TAAATC', 'CAATTT', 'AATTTC', 'TCAATT', 'TAAAT', 'ATTTT', 'AATTT', 'ATAA', 'ATAAAT', 'TATTTT', 'TTATTT', 'TTTT']
TATCTGGTTGTATAGTGCGTTCCGCGGTGTGCAGTTAACTTACGAGCACACCATGCTTCAGCTCTATCCTTCGCCGTTTGC	['ACTTA', 'TTAACT', 'AACTTA', 'ATAGT', 'TATAG', 'GTATA', 'TAGT', 'ATAG', 'GTATAG', 'TGTATA', 'ATAGTG', 'TATAGT', 'TATA']
CGGCAGCGCGAAGATTATGCCGTTCTTTAAAACGCTGCTGGTGGAGCTCGCGCCAGTGTTCGACTCGCTCGATAATAAAAT	['GATAAT', 'AATAA', 'TAATA', 'ATAAT', 'ATAA', 'TAAT', 'TTAAAA', 'TAAAAT', 'ATAATA', 'TAATAA', 'ATAAAA', 'TTTAAA', 'AATAAA']
CCGATAAAGACGCGATAGCGACATCCCGCATAAGGCATTTTTCTCTTTATCTTTGTACGGTACTTCATGGAACAGAGTTTT	['CATAA', 'TATCTT', 'TAAGG', 'ATAG', 'ATTTT', 'ATAA', 'ATTTTT', 'CATAAG', 'TTTTT', 'TTTT', 'CTCTTT', 'TTTTTC', 'TTTTCT']
GGCGCAGGCAAACATATAACGTTGTTATTCGAATTAACGCTGAACGGGCAAAAAGCATCAATTGATAAGTTACGCTATGCC	['ACATA', 'ACATAT', 'CATATA', 'AACATA', 'TCAATT', 'TGTTAT', 'TTGTTA', 'ATAAGT', 'ATATA', 'AATTA', 'TATAA', 'ATAA', 'TATA', 'ATATAA', 'AATTAA']
ACTAACGAAGGCGTGCTGGGTGAAATCGCCCTCTCCTCTCTGCCACGCATTGAGCAAATTTTTGTGAACGCCCCGGCAGGC	['ACTAA', 'ATTTT', 'AATTT', 'AAATTT', 'AATTTT', 'ATTTTT', 'TTTTT', 'TTTT', 'TTTTGT', 'TTTTTG']
ATCAACACCATCACCGGTAACCGCCAATGGGCGCGTGCGCGTACTTATAAATTCCAGACACCGCTTATCCCTGACCTGCAC	['ACTTA', 'TACTTA', 'CTTATA', 'TAAAT', 'TTATA', 'TATAA', 'ATAA', 'TATA', 'TATAAA', 'ATAAAT', 'TAAATT', 'TTATAA']
AATCTGGAATACAAATCTTTTAGTGACTTCGCTTCCGATTTACTCGGGCCGTGGGCAGGATATTTCACCGGCTGGACTTAC	['ACTTA', 'ATACA', 'ATTTCA', 'ATACAA', 'CTTTTA', 'AATACA', 'TTAGT', 'TTTAG', 'TAGT', 'TTTAGT', 'TTTTAG', 'ATTTA', 'TTTTA', 'ATATTT', 'TTTT', 'CTTTT', 'TCTTTT']
GTCGGGCCGGACGGTCGCTACATCAATAAATATATTGCTTATACCGCAGGCGTTGCGCCTGCGAGTCAGCCGCGCTTCGCG	['TATAC', 'CAATAA', 'TTATAC', 'CTTATA', 'AATAA', 'ATATA', 'TAAAT', 'TTATA', 'AAATA', 'TATAT', 'ATAA', 'TATA', 'AATATA', 'TAAATA', 'ATAAAT', 'TATATT', 'AAATAT', 'AATAAA', 'ATATAT', 'TTGCTT']
ATTCCTGGATCGGATAACGAATACTACAAAGTGACGTTAGACACGGCGACTTATGTGCCGATCGATGACGATCACAAATGG	['ACTTA', 'TCACA', 'ATACT', 'TCACAA', 'ATACTA', 'ATCACA', 'TTAGA', 'GTTAGA', 'ATAA', 'TAGACA', 'TTAGAC']
CATATGGTGGCGGATCAGGTAGAGCAGGCTATTTTACGGCGTTTTCCGGGATCGGATGTAATTATCCATCAGGACCCCTGT	['TGTAA', 'GTAATT', 'TGTAAT', 'ATGTAA', 'TAATT', 'ATTTT', 'TTTTA', 'AATTA', 'TAAT', 'AATTAT', 'TATTTT', 'ATTTTA', 'TAATTA', 'TTTT']
TAAGGCGAGATTATTAAAGTTGCCATGCAGCGTCCGGGGAAGTGTTGGGCGCTGTTTTTTTTGTTTCTTAATAATGTGTTG	['CTTAAT', 'TCTTAA', 'TTCTTA', 'TAAGG', 'TAATGT', 'ATAATG', 'AATAA', 'TAATA', 'ATAAT', 'TTAAT', 'ATAA', 'TAAT', 'TATTAA', 'TAATAA', 'TTATTA', 'AATAAT', 'TTAATA', 'TTTTT', 'TTTT', 'TTTTTT', 'GTTTTT', 'TTTTGT', 'TTGTTT', 'TTTGTT', 'TGTTTT', 'TTTTTG']
TTGTCATAATGACCCGCCAACTGATGAAACAGACTGCGGATATTCTGATGCCGGTAAAACATTTGCTGCCGGACAATTTCC	['TCATA', 'CATAA', 'ACAAT', 'ACAATT', 'TCATAA', 'CATAAT', 'CAATTT', 'AATTTC', 'ACATTT', 'ATAATG', 'AATTT', 'ATAAT', 'ATAA', 'TAAT', 'TTGTCA']
CGTTCACAACATAAAAACAAAGCTAAAGCACTTTCTGTTCTCGGTGCTCGCATCCACGCTGCTGAAATGGCAAAACGCCAA	['CATAA', 'TCACA', 'ACATA', 'ACATAA', 'CATAAA', 'TCACAA', 'TTCACA', 'AACATA', 'ATAA', 'TAAAAA', 'ATAAAA']
GCCAGCAACAATATTTATGACTATACCAACGAAACCGCGAACGACGTTTTCGATGTGCGTTTAGCGCAGATGGAAATCAAC	['ACAAT', 'CTATA', 'TATAC', 'ACAATA', 'AACAAT', 'TTTAG', 'ATTTA', 'TATA', 'ATATTT', 'AATATT', 'TATTTA', 'TTTT']
GATTTTTACGTCGTTTGGTTTTCACGGTAGCGTGCCGAGTATTGTCAGCTATATGGATGGCAACATTCGTAAGCTACGCTG	['CTATA', 'TTTTCA', 'ATTTT', 'TTTTA', 'TATAT', 'TATA', 'ATTTTT', 'TTTTTA', 'GCTATA', 'CGAGTA', 'TTGTCA', 'TTTTT', 'TTTT']
GAAGGGGTAGATAAAATTCGCCACTTTCAGGAACTGGGCGTAACAGGATTAGAATGGCATTTTATTGGCCCGTTGCAGTCT	['TAACA', 'TAGAT', 'TTAGA', 'ATTAGA', 'TAGAAT', 'ATTTT', 'TTTTA', 'ATAA', 'AAAATT', 'TTTTAT', 'TAAAAT', 'ATTTTA', 'ATAAAA', 'TTTCAG', 'TTTT']
GTGGCTTTCGAATATTTTACTGTGCGTATTATTCAGTTATTTCGTACTGAACAGAATCAAGCGTATTATAATTGCGAGTCG	['TAATTG', 'TAATT', 'ATTTT', 'TTTTA', 'ATAAT', 'TTATA', 'TATAA', 'ATAA', 'TAAT', 'TATA', 'TATAAT', 'ATATTT', 'AATATT', 'TATTTT', 'TATTAT', 'ATTATA', 'TTATTT', 'ATTTTA', 'ATAATT', 'TTATAA', 'TTTT']
GAGTTACGGGTCAACAATCTCAGCGAACAGTATAAGGAGATGAAAGAAGAACTGGCCGCGGCGCTGATGGACTCACATCAG	['ACAAT', 'TCACA', 'AACAAT', 'TCACAT', 'GTATA', 'TAAGG', 'TATAAG', 'GTATAA', 'AGTATA', 'TAAGGA', 'TATAA', 'ATAA', 'TATA']
GTAGTGAGTCTATTTGTGGTCACTAGCACTGTCTCCTAAACTTGTAAGAGGTCTGAAGCTATTCTTTGATTTTTGCTAGTG	['CCTAAA', 'TGTAA', 'TAGT', 'TGTAAG', 'TAAGAG', 'TTGTAA', 'ATTTT', 'ATTTTT', 'ACTAG', 'CACTAG', 'ACTAGC', 'CTAGCA', 'TTTTT', 'TTTT', 'CTTGT', 'TTTTTG']
GGTGGGTTACTGCGCGGCGAGCGTGTCTTCAATCAATACCGCGAAATAATGCCGGAAACAGAGATCGAAAATTGTTCCCGT	['AATTGT', 'ATAATG', 'AATAA', 'ATAAT', 'AAATA', 'ATAA', 'TAAT', 'AAAATT', 'AAATAA', 'AATAAT']
GCAATTTTTGCCGAAGCTGAAGGTTTACTGGGTTCAAACGAGAATGTAAATGCCGCATTGCTGGAAAAAATGCCGAAACTG	['CAATTT', 'TGTAA', 'TGTAAA', 'ATGTAA', 'AATGTA', 'TAAAT', 'ATTTT', 'AATTT', 'AATTTT', 'ATTTTT', 'TTTTT', 'TTTT', 'TTTTTG']
TATTAACCGCCTTTAAAACCATCAATCTGGAGCCGGGATTTTTCACCATCGTGGTCGGTCATGCGACTTTTTGTGTAGTTG	['ACTTTT', 'TTTTCA', 'TAGTT', 'TAGT', 'TGTAGT', 'TAGTTG', 'ATTTT', 'TTAAAA', 'TATTAA', 'ATTTTT', 'TTTAAA', 'TTTTT', 'TTTT', 'CTTTT', 'TTTTTC', 'CTTTTT', 'TTTTGT', 'TTTTTG']
TCTGGTTCCCCTGCCCGATTTAACAGTGAGCAGCCAAATTAGTACATCGCAGGATACGAAAGACTCACTGCAAGGACAGAA	['TAACA', 'TTAACA', 'TAGTA', 'TTAGT', 'TAGT', 'TTAGTA', 'AATTAG', 'ATTTA', 'AATTA', 'ATTTAA', 'TCCCCT']
CCATCTTAATATGCCCGTTTTAGCGCGTATCATGGATATGCTGGCGTTACTGCTGTTCCTGACATTTAACGGTCATTTATG	['TATCAT', 'ATCTTA', 'ACATTT', 'CTTAAT', 'TCATTT', 'TCTTAA', 'TTTAG', 'TTTTAG', 'TAATA', 'ATTTA', 'TTTTA', 'TTAAT', 'TAAT', 'TAATAT', 'ATTTAA', 'TTAATA', 'TTTT']
TCTGGTGAAGCCTTTTGCGCTGGAAGAGTTACATGCCCGTATCCGCGCCCTGCTACGACGCCATAATAATCAGGGCGAAAG	['CATAA', 'CATAAT', 'TTACAT', 'TAATCA', 'ATAATC', 'CCATAA', 'AATAA', 'TAATA', 'ATAAT', 'ATAA', 'TAAT', 'ATAATA', 'TAATAA', 'AATAAT', 'TTTT', 'CTTTT', 'CCTTTT']
TATGTGTCGTTGCTCTCATTAGTGCCGCTGGTTGCCGTTGTTTTTGCGCTTTTCGCCGCTTTTCCCATGTTTTCCGACGTC	['TTAGT', 'TAGT', 'TTTTT', 'TTTT', 'CTTTT', 'CTTTTC', 'GTTTTT', 'TTGTTT', 'TGTTTT', 'TTTTTG']
ACGCTTATCAGGCCTACGTGGATCGATCAATTTATTGAATTTACACAATTTTGTAGGCCGGATAAGGCGTTCACGCCGCAT	['ACAAT', 'ACAATT', 'TTTACA', 'CAATTT', 'TCAATT', 'TAAGG', 'ATTTA', 'ATTTT', 'AATTT', 'ATAA', 'AATTTT', 'AATTTA', 'TTTT', 'ACACAA', 'TTTTGT']
GCTGAAGTATTTCCAAAAATTAAACTCTGGCAGGGCTTACTGGCAGGTGCTTTAGCCCAACTTTTTGTTCATATGATTTCA	['TCATA', 'ATTTCA', 'ACTTTT', 'TTCATA', 'TTTAG', 'TATGAT', 'AATTA', 'AAAATT', 'AATTAA', 'TTTTT', 'TTTT', 'CTTTT', 'CTTTTT', 'TTTTGT', 'TTTGTT', 'TTTTTG']
CTGGCCAATTTTCAGCACCCAACCCTGAAGCATAACCTCACCACGCTGAAAGCGTTGCACCATGTCGCCTGGATGGACGAC	['CATAA', 'CATAAC', 'CAATTT', 'TTTTCA', 'ATTTT', 'AATTT', 'ATAA', 'AATTTT', 'TTTCAG', 'TTTT']
GCGTACGCCGCAGGATGTTATTTTCGCCGATGAGTGGCGTAACTATCCGGTAACGCTGGTGGCAGAAAATAACGTTACCGA	['AATAAC', 'TGTTAT', 'ATGTTA', 'AATAA', 'ATTTT', 'AAATA', 'ATAA', 'AAAATA', 'TATTTT', 'TTATTT', 'AAATAA', 'TTTT']
CCCATTTTTAATGCCGGACGCAACCAGGCCAATCTGGATATCGCCGAAATTCGCCAGCAGCAGTCGGTGGTGAATTATGAA	['ATTTT', 'TTTTA', 'AATTA', 'TTAAT', 'TAAT', 'AATTAT', 'ATTTTT', 'TTTAAT', 'TTTTAA', 'TTTTTA', 'TTTTT', 'TTTT']
GCATCAAACAGTTTGGTATCAAAACGCCTAAAACAGATGCTATGATTCTCGCAGGGATAATATTATCCGGATCGTTTTCAG	['CCTAAA', 'TTTTCA', 'GATAAT', 'TATGAT', 'TAATA', 'ATAAT', 'ATAA', 'TAAT', 'TAATAT', 'ATATTA', 'AATATT', 'TATTAT', 'ATAATA', 'TTTCAG', 'ATGCTA', 'TTTT']
GAAGCCCGTCTGATTTTTATGGGCGTGGAACATACCCAACCGGAAAAAGGTCGCAAACTGGTTATTGATATTGGCGGCGGA	['ACATA', 'ACATAC', 'AACATA', 'ATTTT', 'TTTTA', 'TTTTAT', 'ATTTTT', 'TTTTTA', 'TTTTT', 'TTTT']
CAGAAGAAGTTGATGTTTTTATCAAAATTTTTGAAAGTTGGGTAACAAAATTACCATCAATATCAGGTCCTGTAAATCTCC	['TAACA', 'TAAATC', 'TAACAA', 'TGTAA', 'TGTAAA', 'TAAAT', 'ATTTT', 'AATTT', 'TTTTA', 'AATTA', 'AAAATT', 'AAATTT', 'AATTTT', 'TTTTAT', 'ATTTTT', 'TTTTTA', 'CTGTAA', 'TTTTT', 'TTTT', 'GTTTTT', 'TGTTTT', 'TTTTTG']
CCGCGACATTGAAAACTGGCCTCATATCAACGGCGTTTTTTATTCCATGGAGGATCAAGAACGTGTTGTCAATGGGTTGCA	['TCATA', 'CCTCAT', 'CTCATA', 'TTTTA', 'TTTTAT', 'TTTTTA', 'TTGTCA', 'TTTTT', 'TTTT', 'TTTTTT', 'GTTTTT']
GTAAAATGCTTCTGCCATGGTTATTCCCACAAACGAAACGGAATAATTTTGCAGCAAAAGTGAACAGTGAGAACCAGGAAA	['GAATAA', 'AATAA', 'TAATT', 'ATTTT', 'AATTT', 'ATAAT', 'ATAA', 'TAAT', 'AATTTT', 'TAAAAT', 'ATAATT', 'TAATTT', 'AATAAT', 'TTTT']
ATGCGATATGTTTATCAGGCCACGTCTTAATGTAATGCTTTGGATTTGCAAATTTTGTAGACCGGATAAGGAATTCACGCC	['CTTAAT', 'TCTTAA', 'TGTAA', 'TAAGG', 'TAATGT', 'TGTAAT', 'TAAGGA', 'ATGTAA', 'AATGTA', 'ATTTT', 'AATTT', 'TTAAT', 'ATAA', 'TAAT', 'AAATTT', 'AATTTT', 'TTTT', 'TTTTGT']
ATGTATATCCTTACTTGCCATGTTCAAAAAACGCGAAAGTGTAAATTCATTTATACTAACAAATATAAATACATTTACCTG	['TAACA', 'ACTAA', 'ATACA', 'ATACT', 'TATAC', 'TATACT', 'ATTCAT', 'CAAATA', 'ACATTT', 'TCATTT', 'ATACTA', 'TTATAC', 'ATACAT', 'TACTAA', 'AATACA', 'TAACAA', 'TTCATT', 'GTATA', 'TGTAA', 'TGTAAA', 'TGTATA', 'ATGTAT', 'ATATA', 'TAAAT', 'ATTTA', 'TTATA', 'AAATA', 'TATAA', 'TATAT', 'ATAA', 'TATA', 'AATATA', 'TATAAA', 'ATATAA', 'TTTATA', 'TAAATA', 'ATAAAT', 'TAAATT', 'AAATAT']
TTTTAATGTGGCTTTCCGGCGAGTATATGACCGCAAATGGTCAATGGGGACTAAACGTCCTACAAACCGCCGACCACAAAG	['ACTAA', 'ACTAAA', 'GTATA', 'TAATGT', 'AGTATA', 'TTTTA', 'TTAAT', 'TATAT', 'TAAT', 'TATA', 'TTTAAT', 'TTTTAA', 'CGAGTA', 'GACTAA', 'TTTT']
TTCCCTACGCAGCTGATATTGCGCATTGAATGTCCGGATGGCGAAATTTGGCTGATTAATCCTTTTAACGGTGAATCGTTA	['CTTTTA', 'AATTT', 'TTTTA', 'TTAAT', 'TAAT', 'AAATTT', 'ATTAAT', 'TTTTAA', 'TTTT', 'CTTTT', 'CCTTTT']
GAGTGAGTTTTCAATCACCTTTCCATCCACCTTATATTAAGCATGGAGGGTTTCAGTTCACGGGCTCATTAGAAAATAATC	['ATAATC', 'CTTATA', 'TTTTCA', 'TTAGA', 'ATTAGA', 'AATAA', 'ATAAT', 'TTATA', 'AAATA', 'TATAT', 'ATAA', 'TAAT', 'TATA', 'ATATTA', 'AAAATA', 'TTATAT', 'TATATT', 'TATTAA', 'AAATAA', 'AATAAT', 'TTTCAG', 'TTTT']
GGGGCGACTTCATTAGCGTGCGCCTGTATTTTAACTTTGCTGTGGCTTCGCGCCAGTTCTGAAGCTACGACATACATATTT	['ATACA', 'ACATA', 'ACATAT', 'ACATAC', 'TTAACT', 'TACATA', 'ATACAT', 'TTCATT', 'ATTTT', 'TTTTA', 'ATATTT', 'TATTTT', 'ATTTTA', 'TTTTAA', 'GACATA', 'TTTT']
GTCAGGGTAATGCTCATGACATGAGCGTCTACTTTGTGAAGACCGGGGATAATAACTGGCAGGTCTACACCCAGGATAGCA	['AATAAC', 'ATAG', 'GATAAT', 'AATAA', 'TAATA', 'ATAAT', 'ATAA', 'TAAT', 'ATAATA', 'TAATAA', 'ATAGCA']
TGACGCAGGCGAAAGCGGAAGCACGACCGATTTACGACATCGCTAATAAAAAATCCCTCGCGGCGGAAGACAGCAAGCTGG	['CTAATA', 'AATAA', 'TAATA', 'ATTTA', 'ATAA', 'TAAT', 'TAAAAA', 'TAATAA', 'ATAAAA', 'AATAAA']
TCGATAAAACCTGGAATCGTCATGATCTGTATTTAAGTACGCTGGTGGTACGTCCTGGCGATAAATCTCGCTCCGCGACGC	['TAAATC', 'TTTAAG', 'TAAGTA', 'TAAAT', 'ATTTA', 'ATAA', 'ATAAAT', 'TATTTA', 'ATTTAA', 'ATAAAA']
AGGCGCTCGAAAATACAATATGGGTATTAGGCTTTGTTGGCACTGCATTTGATACTAAATTTAGTGCCAACAAAGCATCGG	['ACAAT', 'ACTAA', 'ATACA', 'ATACT', 'TACAAT', 'ACAATA', 'ACTAAA', 'CTAAAT', 'ATACTA', 'ATACAA', 'TACTAA', 'AATACA', 'TTAGT', 'TTTAG', 'TAGT', 'ATTTAG', 'TTTAGT', 'TAAAT', 'ATTTA', 'AATTT', 'AAATA', 'AAAATA', 'AAATTT', 'AATTTA', 'TAAATT', 'TTTGTT']
AAAAAATGACCAATTTGATCAGTATAAAAAACAGGTTGGTTATTCACTATTTAAGGACTATATACTATGAACAAAATTATA	['ATACT', 'CTATA', 'TATAC', 'TATACT', 'CAATTT', 'ATACTA', 'ATATAC', 'GTATA', 'TAAGG', 'AAATGA', 'TTTAAG', 'GTATAA', 'AGTATA', 'TAAGGA', 'TTAAGG', 'ATATA', 'ATTTA', 'AATTT', 'TTATA', 'AATTA', 'TATAA', 'TATAT', 'ATAA', 'TATA', 'TATAAA', 'AAAATT', 'AATTAT', 'TATTTA', 'TATATA', 'ATTATA', 'ATTTAA', 'TAAAAA', 'ATAAAA']
CGGTCTAAATAGGCTGATTCAAGGCATTTACGGGAGAAAAAATCGGCTCAAACATGAAGAAATGAAATGACTGAGTCAGCC	['CTAAAT', 'AATAG', 'ATAGG', 'ATAG', 'AAATGA', 'AATAGG', 'AAATAG', 'TAAAT', 'ATTTA', 'AAATA', 'TAAATA', 'ATAGGC']
GCCTATAAAATTGCTGAACTGGCAGGCTTCTCTGTACCAGAAAACACCAAGATTCTGATCGGTGAAGTGACCGTTGTTGAT	['CTATA', 'CTATAA', 'CCTATA', 'TATAA', 'ATAA', 'TATA', 'TATAAA', 'AAAATT', 'TAAAAT', 'ATAAAA']
TCAAGTCTTCATTAAATCAGAACACTGAACATCAGCTGCGTTATCAGGAAACGGAGTTTGTGATTAGTTATGAAGACTTCC	['TAAATC', 'TTCATT', 'TTAGT', 'TAGTT', 'TAGT', 'TTAGTT', 'TAGTTA', 'TAAAT', 'TTAAAT', 'TCAAGT']
AGAACTTTGCCAAAGGTATTGTTTTTGCCGCTATTGTTATTTCAATCGGTTATTCGCTGGCAATATTTTTATGGGGCGTCA	['ATTTCA', 'TGTTAT', 'TTGTTA', 'ATTTT', 'TTTTA', 'ATATTT', 'AATATT', 'TATTTT', 'TTTTAT', 'TTATTT', 'ATTTTT', 'TTTTTA', 'TTTTT', 'TTTT', 'GTTTTT', 'TTGTTT', 'TGTTTT', 'TTTTTG']
CGTCTGGATTTAGTACGTCGCTGCTTCTATTTAAAAGTGTGCGAAAAGCTCAGCCGTGAACGCGCCTGCGTAGGCTGGCGT	['TAGTA', 'TTAGT', 'TTTAG', 'TAGT', 'ATTTAG', 'TTAGTA', 'TTTAGT', 'ATTTA', 'TTAAAA', 'TATTTA', 'ATTTAA', 'TTTAAA']
ATTGTTGCAGGTAATAAAAATGAACTCTTACTGCTGGATCTATCCCATAATAAACTAACAAGTTTACACAATGACTTATTT	['CATAA', 'ACTTA', 'TAACA', 'ACAAT', 'ACTAA', 'TTTACA', 'AAACTA', 'CATAAT', 'AACTAA', 'ACTCTT', 'TAACAA', 'CCATAA', 'AAATGA', 'AATAA', 'TAATA', 'ATAAT', 'ATAA', 'TAAT', 'TAAAAA', 'TTATTT', 'ATAATA', 'TAATAA', 'ATAAAA', 'AATAAA', 'ACACAA']
TGCAACCTGGTGAATTTGTAGCCCGGATAAGGCATTCATGTCACATCCGGCATAAACAAAACGTACGTTGTTAATGTTCGA	['CATAA', 'TCACA', 'ATTCAT', 'CATAAA', 'TCACAT', 'TAAGG', 'TAATGT', 'TTGTTA', 'AATTT', 'TTAAT', 'ATAA', 'TAAT']
GCGAATTTAAAAAGTTATTCGGCTGCTCTCCCCGTGAATACCGCCACCGTGATTATTGGGATCTCGCAAATATCTTCCCTT	['CAAATA', 'TATCTT', 'ATTTA', 'AATTT', 'AAATA', 'TTAAAA', 'AATTTA', 'ATTTAA', 'TAAAAA', 'AAATAT', 'TTTAAA', 'TCCCTT']
TTCAAGGTTATCATTGATACCTATCACAATCATATCCTTGATGAAGAAGCGATTAAATTTCTGGAGAAATTAGATGCCGAG	['TCATA', 'ACAAT', 'TCACA', 'TATCAT', 'AATCAT', 'AATTTC', 'TCACAA', 'ATCATA', 'ATCACA', 'TAGAT', 'TTAGA', 'ATTAGA', 'TTAGAT', 'AATTAG', 'TAAAT', 'AATTT', 'AATTA', 'TTAAAT', 'AAATTT', 'TAAATT']
GTGTTGATCTGGCTGGCACTTTCTCTACTTACCCTAATCCTCATATCAATTTTGTGCAGGCTTTCGCAGTTGAGATGGTGA	['TCATA', 'ACTTA', 'TACTTA', 'CAATTT', 'CCTCAT', 'CTCATA', 'TCAATT', 'CCTAAT', 'ATTTT', 'AATTT', 'TAAT', 'AATTTT', 'TTTT', 'TTTTGT']
GTTTTGCTGGATGGCGAAAAAGTGGGCGAAGTGAAATGGTCGCTGGTAGGCGAACATAATATGCACAATGGCCTGATGGCG	['CATAA', 'ACAAT', 'ACATA', 'ACATAA', 'CATAAT', 'AACATA', 'TAATA', 'ATAAT', 'ATAA', 'TAAT', 'TAATAT', 'ATAATA', 'TTTT']
TTGTATAAATATTACTAAATGCTTGCTTAGTCGCATTGTTAAATGCAATACCGTATATTCGGTATGTAACAGCGATATCCT	['TAACA', 'ACTAA', 'ACTAAA', 'CTAAAT', 'TACTAA', 'TTAGT', 'GTATA', 'TGTAA', 'TAGT', 'TTGTTA', 'GTATAA', 'TGTATA', 'ATGTAA', 'TAAAT', 'AAATA', 'TATAA', 'TATAT', 'ATAA', 'TATA', 'TATAAA', 'TTAAAT', 'TAAATA', 'ATAAAT', 'ATATTA', 'AATATT', 'TATATT', 'AAATAT', 'CTTAGT', 'TTGCTT']
AAAAGCCAGCGGGCGTTACCAGTGGATTTTAATCGACTTACCGCGTGATGCCTCGCAGATAACCCACCAGCTGCTGAGTTT	['ACTTA', 'ATTTT', 'TTTTA', 'TTAAT', 'ATAA', 'TAAT', 'ATTTTA', 'TTTAAT', 'TTTTAA', 'TTTT']
TGAAGGTCAATATGCCCATGTTTATTCTGTCGATACCGATAATTTTGGCGACAGCATTGCGTTGACCGATGCATTAATTGA	['GATAAT', 'TAATTG', 'TAATT', 'ATTTT', 'AATTT', 'ATAAT', 'TTAAT', 'ATAA', 'TAAT', 'ATTAAT', 'AATTTT', 'ATAATT', 'TAATTT', 'TTAATT', 'TTTT']
GCGCTGCTGGGTACGCGTTACACCATGGAACAGGATTTTTATCGCGGGCGGCTGACGGAACAATTTTCCATCAATTGTCTT	['ACAAT', 'ACAATT', 'CAATTT', 'AACAAT', 'TCAATT', 'AATTGT', 'ATTTT', 'AATTT', 'TTTTA', 'AATTTT', 'TTTTAT', 'ATTTTT', 'TTTTTA', 'TTTTT', 'TTTT']
GGCTAGTTTTAAACGTCAGATTAGTCTTAGACGTCAGATTAGTTTTAGATGTCAGATTAGTTTTAGACGTCAGATTAGCTT	['TTAGT', 'TAGAT', 'TTAGA', 'TAGTT', 'TTTAG', 'TAGT', 'TAGTTT', 'TTAGTT', 'TTTAGA', 'TTAGAT', 'TTTTAG', 'TTTTA', 'TTTAAA', 'TTTTAA', 'CTTAGA', 'CTAGTT', 'TTAGAC', 'TTAGCT', 'TCTTAG', 'TTTT']
CAGCCATAGCGTCTGGTGCGATCATAAACAGACCAGTTTTAACGCCGTGGCAGAGTTGATAAACGCCGGGCATCAGGAGAT	['TCATA', 'CATAA', 'TCATAA', 'CATAAA', 'ATCATA', 'ATAG', 'TTTTA', 'ATAA', 'TTTTAA', 'CATAG', 'CATAGC', 'TTTT']
CGGAAAATGACAGGTGGCGGGATGCGCCAGTCCGGCATTCTGGCTGCCGCCGGGATATATGCCCTGAAAAATAACGTTGCG	['AATAAC', 'AAATGA', 'GATATA', 'AATAA', 'ATATA', 'AAATA', 'TATAT', 'ATAA', 'TATA', 'AAAATA', 'AAATAA', 'ATATAT']
ACTTCTTACTGCCGCATTTTTAGCAGCGAGTCCCGCGGCGAAGAGTGCTGTTAATAACGCCTATGATGCATTGATTATTGA	['AATAAC', 'TTCTTA', 'TTTAG', 'TATGAT', 'TTTTAG', 'AATAA', 'TAATA', 'ATTTT', 'TTTTA', 'TTAAT', 'ATAA', 'TAAT', 'ATTTTT', 'TAATAA', 'TTTTTA', 'TTAATA', 'TTAGCA', 'TTTTT', 'TTTT']
CATGGTCTTTTTGTTCGTTCAGCCCGATGCCAGCGCTGCTGACATAAGTGCGCAGCAAATAGGTGGGGTGATTATTCCGCA	['CATAA', 'ACATA', 'ACATAA', 'CAAATA', 'AATAG', 'ATAGG', 'ATAG', 'ATAGGT', 'AATAGG', 'AAATAG', 'ATAAGT', 'AAATA', 'ATAA', 'GACATA', 'CATAAG', 'TTTTT', 'TTTT', 'CTTTT', 'TCTTTT', 'CTTTTT', 'TTTTGT', 'TTTGTT', 'TTTTTG']
TTGTTTATGGGGTCTGGCAAAACGATTAGCCTTGCCGGGCCGTCGATCATTTTCGTTTATATGATCATTGGTTTTATGCTC	['TCATTT', 'TATGAT', 'ATTTT', 'TTTTA', 'TTATA', 'TATAT', 'TATA', 'TTTATA', 'TTATAT', 'TTTTAT', 'TTTT', 'TTGTTT']
CCTTGTGCCGAGCAGAAACTAACCATCTGTACGCCATACTTCAACCTGCCAGCAATCCTTGTGCGCAATATTATCCAGTTG	['ACTAA', 'ATACT', 'AAACTA', 'ATACTT', 'AACTAA', 'ATATTA', 'AATATT', 'TATTAT', 'CTTGT', 'CCTTGT']
GCAAATACACGTTGCCGCTGACGGCGATTAATCAGTTTCTCACGGTTGGCGGTGAATGGCGTCACGACAAACTTAGCGATG	['ACTTA', 'ATACA', 'CAAATA', 'TAATCA', 'AATACA', 'AACTTA', 'TTAAT', 'AAATA', 'TAAT', 'ATTAAT', 'ACTTAG']
ATAGTACGGTGATGATGAAGCTGGAGGCCGTGGGGCTGCGTGGAGCGGCTAAACTAATGCCTTCTGAACTTTCCGGTGGGA	['ACTAA', 'AAACTA', 'AACTAA', 'ACTAAT', 'TAGTA', 'ATAGT', 'TAGT', 'ATAG', 'ATAGTA', 'TAAT']
GTGGACTGGAATGCAACTATTTCATCTTACATCATGCAGCAAACGGCATTGCAGGCATCGTATAAAGCATTTACCGATATG	['ATTTCA', 'TTACAT', 'ATCTTA', 'TTTCAT', 'GTATA', 'GTATAA', 'ATTTA', 'TATAA', 'ATAA', 'TATA', 'TATAAA']
TCGCCGTGGTGAACTCGACGTCGGCTTAATGCGCCATCCTGTTTATAGCCCGGAGATTGATTATCTGGAGCTTTTTGACGA	['CTTAAT', 'TATAG', 'ATAG', 'TTATAG', 'TTATA', 'TTAAT', 'TAAT', 'TATA', 'TTTATA', 'TTTTT', 'TTTT', 'CTTTT', 'CTTTTT', 'TTTTTG']
ACCGTGAAGGTTTGCAGGATGGCCCGAAAGTCTCGTTTAAAGAGATTGCCACTAAATACTGGCGCAGCCTGTTGACATGTA	['ACTAA', 'ATACT', 'ACTAAA', 'CTAAAT', 'TAAAT', 'AAATA', 'TAAATA', 'TTTAAA', 'ATACTG', 'TTGACA']
TGCGGTCAAACATATTCCAGCCTGGTTTTATAAAGAGTGGATCGAACACGTACAGGAAGTTGCGCCAAAGCCGCTGTTTAT	['ACATA', 'ACATAT', 'AACATA', 'TTTTA', 'TTATA', 'TATAA', 'ATAA', 'TATA', 'TATAAA', 'TTTATA', 'TTTTAT', 'TTATAA', 'TTTT']
ACCGACCCGGCATCTATCGAATCTGTTCTGGAAAAAATTCGCGCAGAATTTGGTGAAGTGGATATCCTGGTCAATAATGCC	['CAATAA', 'AGAATT', 'ATAATG', 'AATAA', 'AATTT', 'ATAAT', 'ATAA', 'TAAT', 'AAAATT', 'AATAAT']
CCACATGCAGATCTTTTAAGACTTAAAAAGTGATCATAGAAAAGACTAAGTGACTGTAAAGATGCTCTTTTTTTAAGCATC	['TCATA', 'ACTTA', 'ACTAA', 'ACTTAA', 'CTTAAA', 'CTTTTA', 'ATCATA', 'ATAGA', 'TGTAA', 'ATAG', 'TTTAAG', 'TTAAGA', 'ATAGAA', 'TGTAAA', 'TTTTA', 'TTAAAA', 'TAAAAA', 'TTTTAA', 'TTTTTA', 'CATAG', 'TCATAG', 'ACTAAG', 'CTGTAA', 'AGACTA', 'GACTAA', 'CATAGA', 'TTTTT', 'TTTT', 'TTTTTT', 'CTTTT', 'CTCTTT', 'TCTTTT', 'CTTTTT']
ATAAAAACCGGGAAGATCCTAAGAAGATCTTCCCGGTTGTTTTTTGATCGCCAGTAGTTACCCAGTTAAGCCCGTTTGTGT	['TAGTT', 'TAGT', 'TAGTTA', 'ATAA', 'TAAAAA', 'ATAAAA', 'TTTTT', 'TTTT', 'TTTTTT', 'GTTTTT', 'TTGTTT', 'TGTTTT', 'TTTTTG']
CTGCGCGATGAATTACCGGCGCTGGTTCAGTCGCAATTTAATGTCAGCGACCGCTGCGCCATTAGCGGTCACTCAATGGGT	['CAATTT', 'TAATGT', 'ATTTA', 'AATTT', 'AATTA', 'TTAAT', 'TAAT', 'AATTTA', 'ATTTAA', 'TTTAAT']
ATGGTTTACGCTATGATATCTGGAATGGAGTGACGGTGATTGCTTTTTGTGCCGTACTGTACAATATCTCTCTGTTATTTA	['ACAAT', 'TACAAT', 'ACAATA', 'TGTTAT', 'ATGATA', 'TATGAT', 'ATTTA', 'TATTTA', 'TTATTT', 'TTTTT', 'TTTT', 'TTGCTT', 'CTTTT', 'CTTTTT', 'TTTTGT', 'TTTTTG']
CTAGGTATGGACCGCGATATCATTGTTAATAAAGTGAAAGCGCAGGGCAACATGCCCGCCTATGGTTACACTCCACCGTAT	['TATCAT', 'TACACT', 'TTGTTA', 'AATAA', 'TAATA', 'TTAAT', 'ATAA', 'TAAT', 'TAATAA', 'AATAAA', 'TTAATA']
TTGGAAGCATCACCATTTGTCTTATGTACGCAGACGGTAAAAAAGATCCACAACGGCGGTAAATTGAAAAATTAATTGCCA	['TAATTG', 'TAATT', 'TAAAT', 'AATTA', 'TTAAT', 'TAAT', 'AAAATT', 'ATTAAT', 'TAAATT', 'TAAAAA', 'AATTAA', 'TTAATT']
AGGCCGCAGTACCCGCAGTGCAAACAGAACATTGTTTTCTCACCCACGGTGACATGCCAACCCTCACCATCGATATTTTTA	['ATTTT', 'TTTTA', 'ATATTT', 'TATTTT', 'ATTTTT', 'TTTTTA', 'TTTTT', 'TTTT', 'TTTTCT', 'TTGTTT', 'TGTTTT']
TCGAGTACCATCTGGAAGGCGAAATTCACCACGAATTTAACCGCCACGGTGCGCGCTATCCGTCCTATAACACCATTGTCG	['TAACA', 'CTATA', 'ATAACA', 'CTATAA', 'CCTATA', 'ATTTA', 'AATTT', 'TATAA', 'ATAA', 'TATA', 'AATTTA', 'ATTTAA', 'CGAGTA']
ATCGCCAGCGGCAATGTGCATATAATAAGCCATCCCGGAAATCCCAAATATGAAATAGATGTGAAAGCCGTTGCTGAAGCA	['CAAATA', 'CATATA', 'AATAG', 'TAGAT', 'ATAGA', 'ATAG', 'AATAAG', 'ATAGAT', 'AATAGA', 'AAATAG', 'AATAA', 'ATATA', 'TAATA', 'ATAAT', 'AAATA', 'TATAA', 'ATAA', 'TAAT', 'TATA', 'TATAAT', 'ATATAA', 'ATAATA', 'TAATAA', 'AAATAT']
CTGTTCATCATTAAAAAAACAGTATCGTGATATTTTACGCAAGGGTAGCCCCCATGTTCATTTCCTCTGGTTAGATGGCGA	['TCATTT', 'TTCATT', 'TAGAT', 'TTAGA', 'TTAGAT', 'GTTAGA', 'ATTTT', 'TTTTA', 'TTAAAA', 'ATATTT', 'TATTTT', 'TAAAAA', 'ATTTTA', 'CCCCC', 'TTTT', 'CCCCCA']
CACGCAGCGAGAATGTATCTACATTAATGAAAGTCGTAATATCGATGTGGCGGCAATAGTTTTATCGCTCAACGATGTTAC	['AATAG', 'ATAGT', 'TAGTT', 'TAGT', 'ATAG', 'TAGTTT', 'AATAGT', 'ATGTTA', 'ATAGTT', 'ATGTAT', 'AATGTA', 'TAATA', 'TTTTA', 'TTAAT', 'TAAT', 'TAATAT', 'ATTAAT', 'TTTTAT', 'CAATAG', 'TTTT']
ATTGCAAAACGCAGAGTGATTTTTTCGATATTATCGGCTTTAAGCAATTTCTTTTTGAGCAAACTGAAATGAGCCCAGGTA	['CAATTT', 'AATTTC', 'AAATGA', 'TTTAAG', 'AATGAG', 'ATTTT', 'AATTT', 'ATATTA', 'TATTAT', 'ATTTTT', 'TTTTT', 'TTTT', 'TTTTTT', 'CTTTT', 'TCTTTT', 'TTTTTC', 'CTTTTT', 'TTTTTG']
GTCAGTTGTTGATACGAATTTATCGTCACGATGATAATTGACTGATAAAGGGTTATTAGCTGATAAAGGGCTATTGACTGA	['ATGATA', 'GATAAT', 'TAATTG', 'TAATT', 'ATTTA', 'AATTT', 'ATAAT', 'ATAA', 'TAAT', 'AATTTA', 'ATAATT', 'TTATTA', 'TTAGCT']
TGCATTACAGGGAACTGGCGATGTGCTAAATCAGTTACATATTGATTTTAGAGCCCTTAGCGGTGTCATGGCTGCTGGCTC	['ACATA', 'ACATAT', 'TAAATC', 'TTACAT', 'CTAAAT', 'TACATA', 'TTAGA', 'TTTAG', 'TTTAGA', 'TTTTAG', 'TAAAT', 'ATTTT', 'TTTTA', 'ATTTTA', 'TTTT']
AATGTTGCTGTCTCACGCGCTAAAGATAGTTTTCTGGTATTTGGCGATATGGACCTTATCGAGATGCAGCCCGCATTTTCG	['ATAGT', 'TAGTT', 'TAGT', 'ATAG', 'TAGTTT', 'GATAGT', 'ATAGTT', 'ATTTT', 'TTTT', 'TTTTCT']
TCATTGTACTGTGCATTTTCCCATTAAATTGTTTGCTTTTAATATTCAATGTTAAATATGAGGTGACCGTACAGTAGTTAG	['CTTTTA', 'TAGTT', 'TAGT', 'ATGTTA', 'AATTGT', 'TAGTTA', 'TAATA', 'TAAAT', 'ATTTT', 'TTTTA', 'TTAAT', 'AAATA', 'TAAT', 'TAATAT', 'TTAAAT', 'TAAATA', 'AATATT', 'TAAATT', 'AAATAT', 'TTTAAT', 'TTTTAA', 'TTAATA', 'TTTT', 'TTGCTT', 'CTTTT', 'TTGTTT']
CAAAAGCTGCAGGACGGTAACTGGAGACAGGCAATAACGCAACTGGAAGCGTTAGATAATCGCTATCCGTTTGGTCCGTAT	['CAATAA', 'ATAATC', 'AATAAC', 'TAGAT', 'TTAGA', 'GATAAT', 'TTAGAT', 'GTTAGA', 'AATAA', 'ATAAT', 'ATAA', 'TAAT']
GGTCTGGTGATTCAGGTACCAGAATACTTAAGCCCGGGCGAAAAAATTCGTATCCATATCGAAGAACGCCGTTATATGGGG	['ACTTA', 'ATACT', 'ACTTAA', 'ATACTT', 'TACTTA', 'GTTATA', 'AGAATA', 'TTATA', 'TATAT', 'TATA', 'AAAATT', 'TTATAT']
CACTATTCGCCTTGTTTGTACTGCTGAGTGTGGCGGTTAATTTCGTTCCCACGCCGTGGTGGGGAATGAACAGTGTGATCC	['AATTTC', 'TAATT', 'AATTT', 'TTAAT', 'TAAT', 'TAATTT', 'TTAATT', 'CTTGT', 'CCTTGT', 'CTTGTT', 'TTGTTT']
ATTCATCTTTGCAATTATACTGAATACTGGTAAGCAAATTGTCTTTATGGTTATCATCTCTTATGCATTCATCGTAGGTGT	['ATACT', 'TATAC', 'TATACT', 'TATCAT', 'ATTCAT', 'CAATTA', 'TTATAC', 'AATTGT', 'TTATA', 'AATTA', 'TATA', 'AATTAT', 'ATTATA', 'ATACTG']
GCAATGACGCGCGGTTTAAACTGTCTGTCGCTGTTTGCCGAACGGCTACAAGGGTTTTCTCCTGCCAGCGTCTGTATAGTT	['ATAGT', 'TAGTT', 'TATAG', 'GTATA', 'TAGT', 'ATAG', 'ATAGTT', 'GTATAG', 'TGTATA', 'TATAGT', 'TATA', 'TTTAAA', 'TTTT', 'TTTTCT']
GACGCCAGCCTGAATACAGCTGGCGTTTTCATTTATAAACAGAAAGGAAAACCGATAATAATGGAATGGACGCCCCGACCA	['ATACA', 'TTTCAT', 'TCATTT', 'AATACA', 'TTTTCA', 'TTCATT', 'GATAAT', 'ATAATG', 'AATAA', 'TAATA', 'ATTTA', 'ATAAT', 'TTATA', 'TATAA', 'ATAA', 'TAAT', 'TATA', 'TATAAA', 'TTTATA', 'ATAATA', 'TAATAA', 'TTATAA', 'AATAAT', 'ATACAG', 'TTTT']
GAACTTATTGATCATCTTGATAGTTTGGGTGAAAAAATCATCTGGGCACCCGACAAACATCTGGGGCGTTACGTGCAAAAA	['ACTTA', 'AATCAT', 'AACTTA', 'ATAGT', 'TAGTT', 'TAGT', 'ATAG', 'TAGTTT', 'GATAGT', 'ATAGTT']
GATAGCGGCAAAGTTAAAGGCGCAATGTTGGATGTTTTTAATCGTGAACCCTTACCGCCTGAAAGTCCGCTCTGGCAACAT	['ATAG', 'TTTTA', 'TTAAT', 'TAAT', 'TTTAAT', 'TTTTAA', 'TTTTTA', 'TTTTT', 'TTTT', 'GTTTTT', 'TGTTTT']
GCGATAAAGCAGAAAAGCGAAGGGGCGTTTAATGCCCCTGAGGTTATTGACAACGCTATTTTTAGCCTCGTGAGTGAAGGG	['TTTAG', 'TTTTAG', 'ATTTT', 'TTTTA', 'TTAAT', 'ATAA', 'TAAT', 'TATTTT', 'ATTTTT', 'TTTAAT', 'TTTTTA', 'TTGACA', 'TTTTT', 'TTTT']
TGCTAAAAAATCTTTTCTGAATGTAAAAAAGCTAGAAATCACACAGAAACTTCCAATGATGGGGTTCATACAAGGTGAATC	['TCATA', 'TCACA', 'ATACA', 'ATACAA', 'ATCACA', 'TTCATA', 'TGTAA', 'TGTAAA', 'ATGTAA', 'AATGTA', 'TAAAAA', 'CTAGA', 'CTAGAA', 'TTTT', 'CTTTT', 'TCTTTT', 'CTTTTC', 'TTTTCT']
CATTTTAATGCGGAACACCAGCATACGCGCAAAAAATCGATCGATCTGGAATTTATTGTCTGGCAACGTCTGGCTGGTCTT	['ATTTA', 'ATTTT', 'AATTT', 'TTTTA', 'TTAAT', 'TAAT', 'AATTTA', 'ATTTTA', 'TTTAAT', 'TTTTAA', 'TTTT']
GAGTTACCTAAAGTGAAGCCTTTCTTATCTATAGACTTCAGATTCTGCTTGGAATCCCACCGGCTCAAGAAGCACATGTAT	['CTATA', 'CCTAAA', 'ACCTAA', 'TTCTTA', 'ATAGA', 'TATAG', 'ATAG', 'TATAGA', 'ATGTAT', 'TATA', 'TAGACT', 'CTATAG', 'ATAGAC']
GCGTTAATCGCGCTGGCGTATACGTTTTTTGCTCGTCAGGAGTGGAGCTCGACGGCGATTACCGATCGTCCAACGGTGAAT	['TATAC', 'GTATA', 'TTAAT', 'TAAT', 'TATA', 'TTTTT', 'TTTT', 'TTTTTT', 'GTTTTT', 'TTTTTG']
AGTTTGCATCTGGAGTTAAGCGAAGACGTATTAGCTGAAATTGAAGCGGTGCATCAGGTTTATACTTATCCGGCACCATAA	['CATAA', 'ACTTA', 'ATACT', 'TATAC', 'TATACT', 'ATACTT', 'TACTTA', 'TTATAC', 'CCATAA', 'TTATA', 'ATAA', 'TATA', 'TTTATA', 'TTAGCT', 'TTGCAT']
AAAGGTGCAATCTTTTGCACCTTTAACAGGTTAGCTCGGGCTAACATTCATGATTCTAAAACAAATAAATTATCTCTCTTT	['TAACA', 'ATTCAT', 'CAAATA', 'TTAACA', 'ATTCTA', 'TAACAT', 'AATAA', 'TAAAT', 'AATTA', 'AAATA', 'ATAA', 'ATAAAT', 'AATTAT', 'TAAATT', 'AAATAA', 'AATAAA', 'TAGCTC', 'TTAGCT', 'TTTT', 'CTTTT', 'CTCTTT', 'TCTTTT']
TTGGCGGCCTGCAAGGATTGTAAGACCCGTTAAGGGTTATGAGTCAGGAAAAAAGGCGACAGAGTAATCTGTCGCCTTTTT	['TGTAA', 'TAAGG', 'TGTAAG', 'GAGTAA', 'TTGTAA', 'TAAGGG', 'AGTAAT', 'TTAAGG', 'TAAT', 'TTTTT', 'TTTT', 'CTTTT', 'CCTTTT', 'CTTTTT']
GCGGTAGTTATGGAAGTGCCCGCCGCGATATTAATCGTGCTTGGCTTTTTCACCCGTCCGCTGGCGGTGCTGTTTATTTTC	['TTTTCA', 'TAGTT', 'TAGT', 'TAGTTA', 'ATTTT', 'TTAAT', 'TAAT', 'ATATTA', 'TATTTT', 'ATTAAT', 'TATTAA', 'TTATTT', 'TTTTT', 'TTTT', 'CTTTT', 'TTTTTC', 'CTTTTT']
AAATGGCAAGTCGCGCTTTGCCGAATTGCTTGATGGTGTGGCGTCAGGGCAGTTAAAAGCGTCCTCTGTAAAAAATATTTT	['TGTAA', 'TGTAAA', 'ATTTT', 'AAATA', 'TTAAAA', 'ATATTT', 'AAAATA', 'AATATT', 'TATTTT', 'TAAAAA', 'AAATAT', 'CTGTAA', 'TTTT', 'TTGCTT']
AAAGCGGATGAAAAAGGGGCTGATGTGTTGGTACTGACCTCCGGTCAAACTGACAATAAGATCCACGGCACGGCAAATATT	['ACAAT', 'ACAATA', 'CAAATA', 'CAATAA', 'TAAGAT', 'AATAAG', 'ATAAGA', 'AATAA', 'AAATA', 'ATAA', 'AATATT', 'AAATAT']
ATCGTCGAAGATAAAGTGATCAAAAACCACTTTGCTTCTGAATATATCTACAACGCCTATAAAGATGAAAAAACCTGTGGT	['CTATA', 'CTATAA', 'CCTATA', 'ATATA', 'TATAA', 'TATAT', 'ATAA', 'TATA', 'AATATA', 'TATAAA', 'ATATAT', 'TTGCTT']
CTTTTTCGGATTAGGCTCTTCAGCCGCCGTTGCCCACGATGCGATGAATAAGTTCTTTCGTTTTAATGTTCCGGTGGTGTA	['TAATGT', 'AATAAG', 'GAATAA', 'ATAAGT', 'AATAA', 'TTTTA', 'TTAAT', 'ATAA', 'TAAT', 'TTTAAT', 'TTTTAA', 'TTTTT', 'TTTT', 'CTTTT', 'TTTTTC', 'CTTTTT']
GCAACGCGCTTTTGACAAAAAAGATAAAAATATCAATCACGAACAGGCAGAGCAAAAAGCTCTCGATAATGTCCCGCCGCT	['TAATGT', 'GATAAT', 'ATAATG', 'ATAAT', 'AAATA', 'ATAA', 'TAAT', 'AAAATA', 'TAAAAA', 'ATAAAA', 'AAATAT', 'TTGACA', 'TTTT', 'CTTTT']
CTTTAAAAAACTGGTTGAGTATCCGTACTTCGTACCCGCATGCTGAGAGCGAGTGGGTATTTTTATCACGTAAGGGGAATC	['TAAGG', 'TGAGAG', 'TAAGGG', 'ATTTT', 'TTTTA', 'TTAAAA', 'TATTTT', 'TTTTAT', 'TAAAAA', 'ATTTTT', 'TTTAAA', 'TTTTTA', 'TTTTT', 'TTTT']
CTGGCTTGATGAATTTGCCGAGCCTGCTATAGCCCGCAAAATATATTCATCGGCTTTTCCGTTGGTGGATATTACCGTGGT	['CTATA', 'ATTCAT', 'TATAG', 'ATAG', 'ATATA', 'AATTT', 'AAATA', 'TATAT', 'TATA', 'AATATA', 'ATATTA', 'AAAATA', 'TATATT', 'AAATAT', 'ATATAT', 'GCTATA', 'CTATAG', 'TTTT', 'CTTTT', 'CTTTTC']
CAGTTTACGCTGGTGGTTATTTGTACCCTCGTACTGTGGTTTCATAATGTCTACAGTTCGGCGCTGATGACAATTAACCAG	['TCATA', 'CATAA', 'ACAAT', 'ACAATT', 'TCATAA', 'CATAAT', 'CAATTA', 'TTTCAT', 'TTCATA', 'TAATGT', 'ATAATG', 'ATAAT', 'AATTA', 'ATAA', 'TAAT', 'TTATTT', 'AATTAA']
CTGAAACTGTCCAGGTTTTGGGGGTCAGTTCATAAACGCCTTATCCGGCCTAAAAACAACTAAAATTCAATAAATTGCACC	['TCATA', 'CATAA', 'ACTAA', 'TCATAA', 'CCTAAA', 'ACTAAA', 'CATAAA', 'AACTAA', 'CAATAA', 'TTCATA', 'AATAA', 'TAAAT', 'ATAA', 'ATAAAT', 'AAAATT', 'TAAATT', 'TAAAAA', 'TAAAAT', 'AATAAA', 'TTTT']
CGTTACGAGGGCGAGATTATTCAAAGCGATCGTCCAGGAGAAAATATTCTTTTGTTTAAACGTGCGCTTGGTGTGACTACC	['AAATA', 'AAAATA', 'AATATT', 'AAATAT', 'TTTAAA', 'TTTT', 'CTTTT', 'TCTTTT', 'TTTTGT', 'TTGTTT', 'TTTGTT']
CCTTGAAAGTCTCACTTTCTAGTTGTCCCATGCAGGGGTTGAAATTTGATTCCAAGCGGAAAGTATATTATGTTTTTTCAG	['TTTTCA', 'TAGTT', 'GTATA', 'TAGT', 'AGTATA', 'TAGTTG', 'AATTT', 'TATAT', 'TATA', 'ATATTA', 'AAATTT', 'TATATT', 'TATTAT', 'TCTAG', 'CTAGTT', 'TTTCAG', 'TTTTT', 'TTTT', 'TTTTTT', 'TTTTTC', 'GTTTTT', 'TGTTTT']
CGCCCTGTGGGCGTTTGGCCTGACGGATGAGGTTTTTGCCGCCGCAACCGCAAAACTGGTACGCAATAATCGCCGCTGGAG	['CAATAA', 'ATAATC', 'AATAA', 'ATAAT', 'ATAA', 'TAAT', 'AATAAT', 'TTTTT', 'TTTT', 'GTTTTT', 'TTTTTG']
CGCAGATGGCATTGCGGCGATTAACACCGTTAAATCCATCACCAATATCGATCTTAATCAGAAAATCGGTATGCCGATCGT	['TAACA', 'TAAATC', 'ATCTTA', 'TAATCA', 'TTAACA', 'CTTAAT', 'TCTTAA', 'TAAAT', 'TTAAT', 'TAAT', 'TTAAAT']
CCGTGGTATGAGAATGTTTCTGAAATTTTTGGACATTTAGTCTGGTTCTGGTCTATTGAAATTATTCGCAGAGATTTACGA	['ACATTT', 'TTAGT', 'TTTAG', 'TAGT', 'ATTTAG', 'TTTAGT', 'ATTTA', 'ATTTT', 'AATTT', 'AATTA', 'AATTAT', 'AAATTT', 'AATTTT', 'ATTTTT', 'TTTTT', 'TTTT', 'TTTTTG']
CTTAATGCAAAACTGGATTCCTTAGCGGCAATTATTGAGAAATTTTGCGAGCCACAGGTGGCAATTGTTTCCCTGACGATT	['CAATTA', 'CTTAAT', 'AATTGT', 'ATTTT', 'AATTT', 'AATTA', 'TTAAT', 'TAAT', 'AATTAT', 'AAATTT', 'AATTTT', 'TTTT', 'TTGTTT']
GGCAAAGCGGTTTCCGACGTTGCCGAACGCGATCCGGGCTATCTGCGCTGGTTATTTAATAACCTGGACAGCATGAGCCCG	['AATAAC', 'AATAA', 'TAATA', 'ATTTA', 'TTAAT', 'ATAA', 'TAAT', 'TATTTA', 'ATTTAA', 'TTATTT', 'TAATAA', 'TTTAAT', 'TTAATA']
GTGGTTACAGGAAGTTATCCATTTTAATGTGCTGGCCATTGTGCCTCGTGATTCAACCGTCGAGACATTTGCGTTGGCGGT	['ACATTT', 'TAATGT', 'ATTTT', 'TTTTA', 'TTAAT', 'TAAT', 'ATTTTA', 'TTTAAT', 'TTTTAA', 'AGACAT', 'TTTT']
GGTGAAATTGACTGCAGCGGTAAAATGTTTGACTCGCTGGATCTAATTATTGCCGGTTTTCATGAGCCGGTTTTTGCGCCA	['CTAATT', 'TTTCAT', 'ATCTAA', 'TCTAAT', 'TTTTCA', 'TAATT', 'AATTA', 'TAAT', 'AATTAT', 'TAAAAT', 'TAATTA', 'TTTTT', 'TTTT', 'GTTTTT', 'TTTTTG']
AGGCGTTCACGCCGCATCTGGCATTTGGCTCTCGATGCCTGATGCGACGCTGGCGCGTCTTATCATGCCTACATATTTTTC	['ACATA', 'ACATAT', 'TATCAT', 'TACATA', 'ATTTT', 'ATATTT', 'TATTTT', 'ATTTTT', 'TTTTT', 'TTTT', 'TTTTTC']
CAGGGCAATAAAGTCGAACTGTTGCCAGAAAATAGCGAGTTTAAACCAATTGTCGTTGACCTTCGTCAGCAGAGCTTCACC	['CAATAA', 'AATAG', 'ATAG', 'AATTGT', 'AAATAG', 'AATAA', 'AAATA', 'ATAA', 'AAAATA', 'TTTAAA', 'AATAAA', 'AATAGC']
GATTTGCTGAAATTTATCGAGCATAACCCTCGAATTTGCGGCGTGATTTTTGACTGGGATGAGTACAGTCTCGATTTATGT	['CATAA', 'CATAAC', 'ATTTA', 'ATTTT', 'AATTT', 'ATAA', 'AAATTT', 'AATTTA', 'ATTTTT', 'TTTTT', 'TTTT', 'TTTTTG']
ATGGGGCTACCGCGCGAACTTTTCCTTAATATTGGTTTGCTGGTAGGTGGATTAAGCTGCCTGACAATTCCCTGTTTTGCC	['ACAAT', 'ACAATT', 'ACTTTT', 'CTTAAT', 'TAATA', 'TTAAT', 'TAAT', 'TAATAT', 'AATATT', 'TTAATA', 'TTTT', 'CTTTT', 'CTTTTC', 'TGTTTT']
TAATCAGGACGACTTAATTGAGATGGGTAGTCAGGGTGTGTCAATGAAGCTGGTTCATAACGGTAACCCGAATCGCACGCT	['TCATA', 'CATAA', 'ACTTA', 'ACTTAA', 'TCATAA', 'CATAAC', 'TAATCA', 'CTTAAT', 'TTCATA', 'TAGT', 'TAATTG', 'TAATT', 'TTAAT', 'ATAA', 'TAAT', 'TTAATT']
AACCTGGATGTCCGTTCAAACATGGCTTCTGCCGACCAACCATCGGTCATGGACGAAGCCTATAAAGAGTTTGTTATGCAA	['CTATA', 'CTATAA', 'CCTATA', 'TGTTAT', 'TTGTTA', 'TATAA', 'ATAA', 'TATA', 'TATAAA', 'TTTGTT']
CGGGCATCCCTGAGGTTCAGGACTGGATCACATCAATAGTCGCAGAAGTGGTTTCCCGCTATCCCGTAGATGGCGTGCAGT	['TCACA', 'TCACAT', 'ATCACA', 'AATAG', 'TAGAT', 'ATAGT', 'TAGT', 'ATAG', 'AATAGT', 'CAATAG', 'ATAGTC']
TCTTGTTTACTATAGCTTCTTAAAGTTAAGCCTTGTACTACAGGTTGTTGGAGTACTCCTAGATCACTGTTTCATAGTAGC	['TCATA', 'CTATA', 'TTTCAT', 'CTTAAA', 'TCTTAA', 'TTCTTA', 'TTCATA', 'TAGTA', 'TAGAT', 'ATAGT', 'TATAG', 'TAGT', 'ATAG', 'ATAGTA', 'TAGTAG', 'TATA', 'CATAG', 'CTAGA', 'TCATAG', 'CTATAG', 'CTAGAT', 'CATAGT', 'CTTGT', 'CCTTGT', 'TCTTGT', 'CTTGTT', 'TTGTTT']
AACTGGCTATCTCATTTACCCGCGCATTATCATCAACGCGCACACCATCTTTTTCATAAACACGGTTTATCGGCGCTGTTA	['TCATA', 'CATAA', 'TATCAT', 'TCATAA', 'CATAAA', 'TTTCAT', 'TCATTT', 'TTTTCA', 'TTCATA', 'ATTTA', 'ATAA', 'TTTTT', 'TTTT', 'CTTTT', 'TCTTTT', 'TTTTTC', 'CTTTTT']
ATGCATCGCCTTGTCACCGCAGAAAATTTTGATGAAAACGCTGTGCGCGCACAGGCAGAAAAAATGGCGAATGAGCAAATT	['AATGAG', 'ATTTT', 'AATTT', 'AAAATT', 'AAATTT', 'AATTTT', 'TTGTCA', 'TTTT', 'CTTGT', 'CCTTGT', 'CTTGTC']
AATGTTCCGTGGACGGAACTGGTGCGCGAAGGCGAACTAAAAACGACCGATGAACTGGATGCGATATTTTTTGGTCGCGGC	['ACTAA', 'ACTAAA', 'AACTAA', 'ATTTT', 'ATATTT', 'TATTTT', 'TAAAAA', 'ATTTTT', 'TTTTT', 'TTTT', 'TTTTTT', 'TTTTTG']
TGGCGTTATATCGTCTTGATGAACTGGAAGGCCAGCCGATAGGTCATTTTAATGGCACTTGCATTGATGACCAGGATATCA	['TCATTT', 'ATAGG', 'ATAG', 'GTTATA', 'ATAGGT', 'ATTTT', 'TTTTA', 'TTATA', 'TTAAT', 'TATAT', 'TAAT', 'TATA', 'TTATAT', 'ATTTTA', 'TTTAAT', 'TTTTAA', 'TTGCAT', 'TTTT']
GAAATTACGCTGCCCGATCATGTATTTGAGCTGATTTTTATGCTGCGCCAGCAACTGGATAAATTACCGGATGCGCCTTAT	['ATGTAT', 'TAAAT', 'ATTTT', 'TTTTA', 'AATTA', 'ATAA', 'ATAAAT', 'TTTTAT', 'TAAATT', 'ATTTTT', 'TTTTTA', 'TTTTT', 'TTTT']
TTGGAAGCATCACCCTATTCTGCATACTCTTGAAAAGAAAGCATAACCTAAGCCCCTTAAAAGCATTCAGGATAATTATGA	['CATAA', 'ATACT', 'CATAAC', 'ATACTC', 'CTTAAA', 'ACTCTT', 'ACCTAA', 'CCCTAT', 'GATAAT', 'TAATT', 'ATAAT', 'AATTA', 'ATAA', 'TAAT', 'TTAAAA', 'AATTAT', 'ATAATT', 'TAATTA', 'CCCCTT']
CCAAATTTCAAACCTTACATGGAGGTTATTATAGTATATTTGACACCCTATATACCTGTGATTAGAGATGTGTATATATAT	['CTATA', 'TATAC', 'ATTTCA', 'TTACAT', 'AATTTC', 'CCTATA', 'CCCTAT', 'ATATAC', 'TAGTA', 'TTAGA', 'ATAGT', 'TATAG', 'GTATA', 'TAGT', 'ATAG', 'ATTAGA', 'TTATAG', 'TAGTAT', 'AGTATA', 'TGTATA', 'ATAGTA', 'TATAGT', 'TAGAGA', 'ATATA', 'AATTT', 'TTATA', 'TATAT', 'TATA', 'ATATTT', 'AAATTT', 'TATATA', 'TATATT', 'TATTAT', 'ATTATA', 'TTATTA', 'ATATAT', 'TTGACA']
ACGCTAACCATCACTCAGGACACCTCCAAAGCGCAAACGGCGATTAAAGACTGGGTGAATGCCTACAACTCGCTAATAGAT	['CTAATA', 'AATAG', 'TAGAT', 'ATAGA', 'ATAG', 'ATAGAT', 'TAATAG', 'AATAGA', 'TAATA', 'TAAT']
GAGCATATACAAATATATTAGTCTAAGTTTTGTATGCTAACAGAAAGATATAATTTAGCTACCTATTCTAAAAATGGTGAA	['TAACA', 'ATACA', 'TATAC', 'TATACA', 'CAAATA', 'CATATA', 'ATACAA', 'ATTCTA', 'ATATAC', 'TTAGT', 'TTTAG', 'TAGT', 'ATTTAG', 'GATATA', 'ATATA', 'TAATT', 'ATTTA', 'AATTT', 'ATAAT', 'AAATA', 'TATAA', 'TATAT', 'ATAA', 'TAAT', 'TATA', 'AATATA', 'TATAAT', 'ATATAA', 'ATATTA', 'TATATT', 'AATTTA', 'TAAAAA', 'ATAATT', 'AAATAT', 'TAATTT', 'ATATAT', 'TAGCTA', 'ATGCTA', 'TTAGCT', 'TTTT', 'TTTTGT']
TATAGCCTCAGTGATAAAGGCTTGCGCCTGACGCGACGGGCAGAAAGTAAAATTTATCGCGCAGAGCAACCTGCATGGGAT	['TATAG', 'ATAG', 'AAGTAA', 'ATTTA', 'AATTT', 'ATAA', 'TATA', 'AAAATT', 'AAATTT', 'AATTTA', 'TAAAAT']
CGCGCAAACGTAGCATTCCGGGGATATCGTTTATACGTGATTACGCCGATAACCACGATTACATTAATGCACTGGCGAACA	['TATAC', 'TTACAT', 'TTATAC', 'TTATA', 'TTAAT', 'ATAA', 'TAAT', 'TATA', 'TTTATA', 'ATTAAT', 'TAGCAT']
AAGCGCAACAGCCTCGATGCGTTATGTGCTCGCTACGAAATAGATAACAGTAAACGAACGCTGCACGGGGCATTACTCGAT	['TAACA', 'ATAACA', 'AATAG', 'TAGAT', 'ATAGA', 'ATAG', 'ATAGAT', 'AATAGA', 'AAATAG', 'AAATA', 'ATAA']
AATTCTTTACGCGACCCTGAAGGGTAAAAATAGCGAGGCCAAATCCGATGAGCCCCAATACGGTGCTATTTTTAAACGCGC	['AATAG', 'ATAG', 'AAATAG', 'ATTTT', 'TTTTA', 'AAATA', 'AAAATA', 'TATTTT', 'TAAAAA', 'ATTTTT', 'TTTAAA', 'TTTTAA', 'TTTTTA', 'AATAGC', 'TTTTT', 'TTTT']
GGGTGGTGCAGTGTATCTGGACGTCAACTATAAATTTGTACCATGGTTTAATCTGACAGTACGAAATCGCTATAACCATAA	['CATAA', 'CTATA', 'CTATAA', 'CCATAA', 'TAAAT', 'AATTT', 'TTAAT', 'TATAA', 'ATAA', 'TAAT', 'TATA', 'TATAAA', 'ATAAAT', 'AAATTT', 'TAAATT', 'TTTAAT', 'GCTATA']
ATGAACGGCGTCGGTTGCCGTGCCACCGCACGACTAATGGGCGTGGGCCTCAACACCATTTTGCGCCATTTAAAAAACTCA	['ACTAA', 'ACTAAT', 'ATTTA', 'ATTTT', 'TAAT', 'TTAAAA', 'ATTTAA', 'TAAAAA', 'TTTAAA', 'GACTAA', 'TTTT']
TATGAAACATTACCGTCCGCTGTTATTAAACGACACGCTATTTTTACGAAAACTCTGCGTCACCTTAAGTCATAAAAATTA	['TCATA', 'CATAA', 'TCATAA', 'CATAAA', 'TGTTAT', 'ATTTT', 'TTTTA', 'AATTA', 'ATAA', 'AAAATT', 'TATTTT', 'TATTAA', 'TAAAAA', 'ATTTTT', 'TTATTA', 'ATAAAA', 'TTTTTA', 'TTTTT', 'TTTT']
TAGCGCATCAGGCAATGTTGCGTTTGTCATCAGTTTCAAATGGCGCTGTAAAAGGCGTCATTTTCATATTGTAGACAACGT	['TCATA', 'TCAAAT', 'TTTCAT', 'TCATTT', 'TTTTCA', 'TTCATA', 'TGTAA', 'TGTAAA', 'ATTTT', 'TAGACA', 'CTGTAA', 'TTGTCA', 'TTTT']
GAATCCAACTTATGTTGTAAACTGGCAAGGTAATGTCATTAGTCATAATAGTGCTTTTGAACATTATTTCACTGCGGATTA	['TCATA', 'CATAA', 'ACTTA', 'ATTTCA', 'TCATAA', 'CATAAT', 'AACTTA', 'AATAG', 'TTAGT', 'ATAGT', 'TGTAA', 'TAGT', 'ATAG', 'TAATGT', 'AATAGT', 'TGTAAA', 'TAATAG', 'TTGTAA', 'ATAGTG', 'TAATA', 'ATAAT', 'ATAA', 'TAAT', 'TTATTT', 'ATAATA', 'TTTT', 'CTTTT']
TGCTGGTAACTGGCCCTACCGGCAGCGGCAAAACGGTCACGCTTTATAGTGCCCTGCAAAAGCTGAATACCGCTGACATTA	['ATAGT', 'TATAG', 'TAGT', 'ATAG', 'TTATAG', 'ATAGTG', 'TATAGT', 'TTATA', 'TATA', 'TTTATA', 'GCCCTA']
TCTTTTATTCAGAATTATGTCGCGATTATTGTCCTGTTTTGCGCCAGCGGCACCGGGATCTTCGGGGCGATGAACGAAGGG	['CTTTTA', 'AGAATT', 'TTTTA', 'AATTA', 'AATTAT', 'TTTTAT', 'TTTT', 'CTTTT', 'TCTTTT', 'TGTTTT']
TTTACAAGGAAGCGAAGACTCACAAGTTGCTAGCGAGATATTTCTTTGTGCTATTGCTTGGATTCTTCATCATGAAATAAG	['TCACA', 'TTTACA', 'TCACAA', 'AATAAG', 'AATAA', 'AAATA', 'ATAA', 'ATATTT', 'AAATAA', 'TTGCTT']
AAATCCTCCCTTACCCTTGTTCCTTTACTCTAGGTTGAAAAAACAACAGCGTCAATAGGCCTGCCATGTACGAAGCGAGAT	['AATAG', 'ATAGG', 'ATAG', 'AATAGG', 'TCTAG', 'CTCTAG', 'ATAGGC', 'CAATAG', 'CTTGT', 'CCTTGT', 'CTTGTT', 'TCCCTT']
CATCTACGAGATAACTTTTTTAAACTGAATCGCGAACTGCACGATAAATCGCTGCGGTTGAATCTTCATCTGGATCAGGAA	['TAAATC', 'ACTTTT', 'TAAAT', 'TTTTA', 'ATAA', 'ATAAAT', 'TTTAAA', 'TTTTAA', 'TTTTTA', 'TTTTT', 'TTTT', 'TTTTTT', 'CTTTT', 'CTTTTT']
ATGACATTTGCTAACGGCGCGGTAAGATCGGCTTTGTGGTTGAGTGGTAAGGAAAGCGGTCTTTTTGATATGCGAGATGTA	['ACATTT', 'TAAGG', 'TAAGAT', 'TAAGGA', 'TTTTT', 'TTTT', 'CTTTT', 'TCTTTT', 'CTTTTT', 'TTTTTG']
ATTGCCAGTTAAACACCGCTTTATCCGTGGTTTGGGAATTGGTCGAAGTGTTTTAATTGTTGATGAAGTTCATGCTTACGA	['AATTGT', 'TAATTG', 'TAATT', 'TTTTA', 'TTAAT', 'TAAT', 'TTTAAT', 'TTTTAA', 'TTAATT', 'TTTT', 'TGTTTT']
CCCCCCCATCGAGCAGAAAACGGTGGTGGATGGCGAACCTGTTTTACGAGTGCGTAATCTTGTCACCCGTTTCCCTTTGCG	['TTTTA', 'TAAT', 'TTGTCA', 'CCCCC', 'CCCCCC', 'TTTT', 'CTTGT', 'TCTTGT', 'CTTGTC', 'CCCTTT', 'TCCCTT', 'CCCCCA', 'TGTTTT']
TACAGTACTTTAGCGGAGGAACTCTCTACTACCGTTCATGCGCTGGCTCTGCATACTTACACTATTAAGGAGTGGGAAGGG	['ACTTA', 'ATACT', 'CTATTA', 'ATACTT', 'TACTTA', 'TACACT', 'TTTAG', 'TAAGG', 'TAAGGA', 'TTAAGG', 'TATTAA']
CTGTTTGCATTGGGAATCGGCATCTATATTTTATATAGCGCGTTACGCATGGGATATGAGGCGGTACAGTCATTACTGGAT	['CTATA', 'TATAG', 'ATAG', 'ATATAG', 'ATATA', 'ATTTT', 'TTTTA', 'TTATA', 'TATAT', 'TATA', 'TTTATA', 'ATATTT', 'TTATAT', 'TATTTT', 'TATATA', 'TATATT', 'TTTTAT', 'ATTTTA', 'TTGCAT', 'TTTT']
AACAAAGGAAGTTCATAAGAAAAGCCATGTCGGCTTTTCCTCTACTAGATACAGATTGGAGGTAGATGAATATTTGCCAAA	['TCATA', 'CATAA', 'ATACA', 'TCATAA', 'TTCATA', 'TAGAT', 'ATTGGA', 'GAGGTA', 'ATAAGA', 'ATAA', 'ATATTT', 'AATATT', 'ACTAG', 'CTAGA', 'CATAAG', 'CTAGAT', 'ATACAG', 'ACTAGA', 'GATACA', 'TACTAG', 'TTTT', 'CTTTT', 'CTTTTC']
GCGGTGGTGACTGGTTTTTCGATTTAAATGATTCAGAGCAACAAGAGGCAATAGATCTGTTGCTGAAATTCCATCACCTTC	['AATAG', 'TAGAT', 'ATAGA', 'ATAG', 'AAATGA', 'ATAGAT', 'AATAGA', 'TAAAT', 'ATTTA', 'TTAAAT', 'ATTTAA', 'TTTAAA', 'CAATAG', 'TTTTT', 'TTTT', 'TTTTTC', 'GTTTTT']
CCTGCATTAACCTGCAATTTTTAGCCAAATAGCGGTCAACAAAAAAGGGGGCCCTGAACTCATCAGCGCCCCCTTTTATTT	['ACTCAT', 'CAAATA', 'CAATTT', 'CTTTTA', 'AATAG', 'TTTAG', 'ATAG', 'AAATAG', 'TTTTAG', 'ATTTT', 'AATTT', 'TTTTA', 'AAATA', 'AATTTT', 'TTTTAT', 'TTATTT', 'ATTTTT', 'TTTTTA', 'AATAGC', 'CCCCC', 'TTTTT', 'TTTT', 'CTTTT', 'CCCCTT', 'CCTTTT', 'CCCTTT']
GGGTGGCGATTAAAGCTGGCTCATTAATTGCCGTGCTTATTTTGCGACAGACCAACAACTATAACAGCGATGATTTCCAGT	['TAACA', 'CTATA', 'ATAACA', 'CTATAA', 'TAATTG', 'TAATT', 'ATTTT', 'TTAAT', 'TATAA', 'ATAA', 'TAAT', 'TATA', 'TATTTT', 'ATTAAT', 'TTATTT', 'TTAATT', 'TTTT']
GTGTGTGTGCAACAACCGATGTTTACCGAAATGTTTGGTGCCAGTTATCGCTATAGTGGCGCTGGAGTCGGTTATCAGGTT	['CTATA', 'ATAGT', 'TATAG', 'TAGT', 'ATAG', 'ATAGTG', 'TATAGT', 'TATA', 'GCTATA', 'CTATAG']
AAGTGCTCTCTTTTATACAATATGCATTGCATCTGGACCTTAAACTTATAAAAATGGTCAGTGAAACTTCTGTGAACATGA	['ACTTA', 'ACAAT', 'ATACA', 'TATAC', 'TATACA', 'TACAAT', 'ACAATA', 'CTTAAA', 'TTATAC', 'ATACAA', 'CTTTTA', 'CTTATA', 'AACTTA', 'TTTTA', 'TTATA', 'TATAA', 'ATAA', 'TATA', 'TATAAA', 'TTTATA', 'TTTTAT', 'TAAAAA', 'ATAAAA', 'TTATAA', 'TTGCAT', 'TTTT', 'CTTTT', 'CTCTTT', 'TCTTTT']
CAACCTTTTACCTTAAGGTTCCGGAAGGCTGGTTCATTCCGGCTGATGCGCTACAAGGAATGGTGCTGGGTTATTTGAGCC	['CTTTTA', 'TTCATT', 'TAAGG', 'TAAGGT', 'TTAAGG', 'TTTTA', 'TTATTT', 'TTTT', 'CTTTT', 'CCTTTT']
ATGTGATGAGCCGTTCATGATACAGGAGTAGTAAAGGGCATATTTTACCAATGTTAAGGCGACTTTCCGTTTTATTGCGAG	['ATACA', 'TAGTA', 'TAAGG', 'TAGT', 'TAGTAA', 'ATGATA', 'GAGTAG', 'ATGTTA', 'TTAAGG', 'ATTTT', 'TTTTA', 'ATATTT', 'TATTTT', 'TTTTAT', 'ATTTTA', 'ATACAG', 'GATACA', 'TTTT']
ATGGACACAACGTTGAGTGAAGCACCCACTTGTTGTCATACAGACCTGTTTTAACGCCTGCTCCGTAATAAGAGCAGGCGT	['TCATA', 'ATACA', 'AATAAG', 'TAAGAG', 'ATAAGA', 'AATAA', 'TAATA', 'TTTTA', 'ATAA', 'TAAT', 'TAATAA', 'TTTTAA', 'ATACAG', 'TTGTCA', 'TTTT', 'CTTGT', 'CTTGTT', 'ACACAA', 'TGTTTT']
TACCATCGCATCTGATGACCTGTGGATCGAGAGTTTAGCGATCCAACAATTACACACCACGGCAAATTTACCCAACATGCA	['ACAAT', 'ACAATT', 'CAATTA', 'AACAAT', 'TTTAG', 'ATTTA', 'AATTT', 'AATTA', 'AAATTT', 'AATTTA']
GACCTGGCGGCCTTCACGCTGGCTCGTGACCATAAATTACCGATTCGTGTTTTCAATATGAACAAACCGGGTGCGCTGCGC	['CATAA', 'CATAAA', 'TTTTCA', 'CCATAA', 'TAAAT', 'AATTA', 'ATAA', 'ATAAAT', 'TAAATT', 'TTTT', 'TGTTTT']
GACGCAGAAGTGCTTATACCAGGATTACGTGTGGAATTTTGCCGCGTAAATGGCCTGCGAGGACCAACAGCGGCAAATGTT	['TATAC', 'TTATAC', 'CTTATA', 'TAAAT', 'ATTTT', 'AATTT', 'TTATA', 'TATA', 'AATTTT', 'TTTT']
ATAGCGGCTCCCACAATGTTCAAATGTGGGAGCTATTTACCAGCACATCTTACACTTATGATGAGAACTCCTGGCGAATTT	['ACTTA', 'ACAAT', 'ATCTTA', 'ACACTT', 'TCAAAT', 'TACACT', 'ATAG', 'TATGAT', 'ATTTA', 'AATTT', 'TATTTA']
CGTTTCCGGCATTTGCTCTGGGGATGCTTTTAATTCAGGTATTCTCCGTTGAACTGGGCTGGCTGCCTACCGTGGGAGCAG	['CTTTTA', 'TAATTC', 'TAATT', 'TTTTA', 'TTAAT', 'TAAT', 'TTTAAT', 'TTTTAA', 'TTAATT', 'TTTT', 'CTTTT']
TTTAGACACCGGTGATATGCTCTATAAGCTCTCCTGCCCGATTACTGCAGAAGATACCAGTGGTACGCTGTACGACAAGCT	['CTATA', 'CTATAA', 'TTAGA', 'TTTAG', 'TATAAG', 'TTTAGA', 'TATAA', 'ATAA', 'TATA', 'TAGACA', 'TTAGAC']
CGATGCTGGCAGATGTTAAACCGGGTAAGAAGATAATTATTCTGGGAGCAGGTTGTATTGGTTTGATGACGTTGCAAGCGT	['ATGTTA', 'GATAAT', 'TAATT', 'ATAAT', 'AATTA', 'ATAA', 'TAAT', 'AATTAT', 'ATAATT', 'TAATTA']
TGTCTGGGAAGCTGCCTGATGGAGGGGGATAACTACTGGAAACGGTAGCTAATACCGCATAATGTCGCAAGACCAAAGAGG	['CATAA', 'CTAATA', 'CATAAT', 'TAATGT', 'ATAATG', 'TAATA', 'ATAAT', 'ATAA', 'TAAT', 'TAGCTA']
CGATGCGTTGACCGATCATTCCAGTGAATTTATCGAGCAGCTGCACGATAAAATTATCGACCTTGAAGATAATCTCCTTGA	['ATAATC', 'GATAAT', 'ATTTA', 'AATTT', 'ATAAT', 'AATTA', 'ATAA', 'TAAT', 'AAAATT', 'AATTAT', 'AATTTA', 'TAAAAT', 'ATAAAA']
AAGGATCACCTATTGCAACAAGTGCTGTTTGATCTGGTGCAAACAGATACCATTAAAAATAGTCTGACGCTCGGCTCGCAT	['AATAG', 'ATAGT', 'TAGT', 'ATAG', 'AATAGT', 'AAATAG', 'AAATA', 'TTAAAA', 'AAAATA', 'TAAAAA', 'ATAGTC']
CTTCGTTCCCGGCACGCTGGCTGATGGCGTGGTGTATGTCTCCGGTACGCTGGCTTTTGATCAACATAATAACGTGCTGTT	['CATAA', 'ACATA', 'ACATAA', 'CATAAT', 'AACATA', 'AATAAC', 'AATAA', 'TAATA', 'ATAAT', 'ATAA', 'TAAT', 'ATAATA', 'TAATAA', 'TTTT', 'CTTTT']
GATGAAATTTATATGGCGTTGTCGATGGCCGATATTTTCATTGCCATTGGCACATCCGGGCATGTTTATCCGGCGGCTGGG	['TTTCAT', 'TTTTCA', 'TTCATT', 'ATTTA', 'ATTTT', 'AATTT', 'TTATA', 'TATAT', 'TATA', 'TTTATA', 'ATATTT', 'TTATAT', 'AAATTT', 'TATTTT', 'AATTTA', 'TTTT']
GGCTTTATCATCGACGATAGCGTACTTTATAGCGGTGCCAGCCTGAACGATGTTTACCTGCATCAGCACGATAAATATCGC	['TATCAT', 'TATAG', 'ATAG', 'TTATAG', 'TAAAT', 'TTATA', 'AAATA', 'ATAA', 'TATA', 'TTTATA', 'TAAATA', 'ATAAAT', 'AAATAT']
CTGCGCCTTTATTTATCACCAGCAGGAAACGCCTTGTCCATAGACGCCCCTTCCACATGCGCCACAAGAAACCTCTATTCC	['ATAGA', 'ATAG', 'ATTTA', 'TATTTA', 'TTATTT', 'CATAG', 'ATAGAC', 'CATAGA', 'CTTGT', 'CCTTGT', 'CTTGTC', 'CCCCTT']
TAATGTGCCGTCCCGTACTGGCTGCGATCTGCTCCCGGAAACGGTGGGCCGTCTGGCGAAAGTAAAAAATATTATCGGAAT	['TAATGT', 'AAGTAA', 'AAATA', 'TAAT', 'ATATTA', 'AAAATA', 'AATATT', 'TATTAT', 'TAAAAA', 'AAATAT']
CCTTGAGTCAGCGCCGGGAACGTTTATTAGAAAAATAAATAAAACCAGCGTTGTGTTTGAAACTCACGGGCATTACGAAAA	['TTAGA', 'ATTAGA', 'AATAA', 'TAAAT', 'AAATA', 'ATAA', 'TAAATA', 'ATAAAT', 'AAAATA', 'TTATTA', 'ATAAAA', 'AAATAA', 'AATAAA']
CAAAGATGTGAGTAATAAAATTCTCACCAACCAGACCAACCTGACCTCGACGTTCTATACCGGTTCTATCGGTCATGATGT	['CTATA', 'TATAC', 'GAGTAA', 'TGTGAG', 'AGTAAT', 'AATAA', 'TAATA', 'ATAA', 'TAAT', 'TATA', 'AAAATT', 'TAAAAT', 'TAATAA', 'ATAAAA', 'AATAAA']
TCAAACTGTTTAATCAAGCAATAAGCGGCGCACCTTACACTGCGCTGTCGGTTCCCCTTTCTTTAACTGCTGATTCTGTTT	['TAATCA', 'CAATAA', 'TTAACT', 'TACACT', 'AATAAG', 'AATAA', 'TTAAT', 'ATAA', 'TAAT', 'TTTAAT', 'CCCCTT', 'CCCTTT', 'TCCCCT']
TTCGATGGCCGGCGCGGCGCTGTGCTTTTTTATCGCCAGAGTGATGGGCCGCGAAGTGGTGGAAAAATTAACCGGCAAAAC	['TTTTA', 'AATTA', 'AAAATT', 'TTTTAT', 'AATTAA', 'TTTTTA', 'TTTTT', 'TTTT', 'TTTTTT', 'CTTTT', 'CTTTTT']
GCTATCGTGATTGTAGTTAACGTCTTTATGGCACGCCGACTGAGCTTCAATAAGGCAGATGAAATTACTATCGTCTTTTGT	['CAATAA', 'TAGTT', 'TAAGG', 'TAGT', 'AATAAG', 'TGTAGT', 'TAGTTA', 'AATAA', 'AATTA', 'ATAA', 'TTTT', 'CTTTT', 'TCTTTT', 'TTTTGT']
TAACTGCAACGGTTAAAGATCAGTTCGACAATGAGGTGAATAATCTTCCGGTAACATTCAGCTCAGCCTCTTCAGGACTCA	['TAACA', 'ACAAT', 'ATAATC', 'TAACAT', 'AATGAG', 'GAATAA', 'AATAA', 'ATAAT', 'ATAA', 'TAAT', 'AATAAT']
CGCAAAATGGCTCCCGCTCTTTTGACCGGTAATACCATCGTCATTAAACCTAGTGAATTTACGCCAAACAATGCGATTGCA	['ACAAT', 'AACAAT', 'TAGT', 'TAATA', 'ATTTA', 'AATTT', 'TAAT', 'AATTTA', 'ACCTAG', 'TTTT', 'CTTTT', 'CTCTTT', 'TCTTTT']
GAATTTAAAGAAATGATTAGCAGAGATGCGTTCCTCGAACACGCAGAAGTTTTTGGTAATTACTATGGCACTTCGCGTGAG	['AAATGA', 'GTAATT', 'TAATT', 'ATTTA', 'AATTT', 'AATTA', 'TAAT', 'AATTTA', 'ATTTAA', 'TAATTA', 'TTTAAA', 'TTAGCA', 'TTTTT', 'TTTT', 'GTTTTT', 'TTTTTG']
GATAAAATGTTAGGCTGGCAACGCGCTGGTGGCGAAGGCATCCTGACGACAATCTACGGTATTCTGGTGTTTTTACCGTGG	['ACAAT', 'ATGTTA', 'TTTTA', 'ATAA', 'TAAAAT', 'ATAAAA', 'TTTTTA', 'TTTTT', 'TTTT', 'GTTTTT', 'TGTTTT']
AATATCCGTTTATTGAACTGTTGATTAATGAGAATTACCCGCATCTCAATGAAGGAAAAGATAATCGCGGTCTTTTATCCT	['ATAATC', 'CTTTTA', 'AATGAG', 'GATAAT', 'AGAATT', 'TTTTA', 'ATAAT', 'AATTA', 'TTAAT', 'ATAA', 'TAAT', 'ATTAAT', 'TTTTAT', 'TTTT', 'CTTTT', 'TCTTTT']
AACGGCATCGCCGCTATCGGCTATAAATCTCAGCCGGTACTGGTTCAGCCTGGTCAGACTGGCGCGATGAACAGCACCCTG	['CTATA', 'CTATAA', 'TAAATC', 'TAAAT', 'TATAA', 'ATAA', 'TATA', 'TATAAA', 'ATAAAT', 'GCTATA']
AAACCGGATCGCTTTTTTCGCATCGTTGCGCAGGAGCGCGGCTGGCGTTTAGCAAAAAACTACGCTGTCGGGATGCTCTTC	['AAACTA', 'TTTAG', 'TAGCAA', 'TTAGCA', 'TTTTT', 'TTTT', 'TTTTTT', 'CTTTT', 'TTTTTC', 'CTTTTT']
CACATACGGATAAAAATGCCATGGAAATCGTGGATGGTTTTCACCGCCATGAAATTGGTAAAGGCTCATCATCATTAAAAT	['ACATA', 'ACATAC', 'CACATA', 'TTTTCA', 'ATAA', 'TTAAAA', 'TAAAAA', 'TAAAAT', 'ATAAAA', 'TTTT']
GTACATCAGGTAAAACTGACCGATAAGCCGCTTTCTTTTGGGTATAGTGTCGTGGACAGTCATTCATCTTTCTGCCCCTCC	['ATTCAT', 'ATAGT', 'TATAG', 'GTATA', 'TAGT', 'ATAG', 'GTATAG', 'TAGTGT', 'ATAGTG', 'TATAGT', 'GGTATA', 'ATAA', 'TATA', 'TTTT', 'CTTTT', 'CCCTCC', 'TCTTTT']
CGCGACCAAAAATTTACTCGTTCGCCGTGTACTGGATGATTTTAACGCTGGGGCCGCTGCTGGCAGGGGCCAGTCTGGCGA	['ATTTA', 'ATTTT', 'AATTT', 'TTTTA', 'AAAATT', 'AAATTT', 'AATTTA', 'ATTTTA', 'TTTTAA', 'TTTT']
GCGCCGCATCCGACATCCGGAGTACCATGCCTGATACGACGCTTGTGCGTCTTTTCATGCCGACCAAAATATTACCCAATG	['TTTCAT', 'TTTTCA', 'AAATA', 'ATATTA', 'AAAATA', 'AATATT', 'AAATAT', 'TTTT', 'CTTGT', 'CTTTT', 'TCTTTT', 'CTTTTC']
GGCCTGGTTAACGCAGCAGATAACTATCAGAACGCGGGCTGGCGCACCTTTTTTGTTGATAATCAGGTGAAGACGCTGATT	['TAATCA', 'ATAATC', 'GATAAT', 'ATAAT', 'ATAA', 'TAAT', 'TTTTT', 'TTTT', 'TTTTTT', 'CTTTT', 'CCTTTT', 'CTTTTT', 'TTTTGT', 'TTTGTT', 'TTTTTG']
CTTAAAATTATTTGCTTCGCTGTTAATTTCACTTTCATATTCTAGTGCCTACGCAGATTTATCAGAAACAGTGTATATTAA	['TCATA', 'ATTTCA', 'AATTTC', 'TTTCAT', 'CTTAAA', 'ATTCTA', 'TTCATA', 'GTATA', 'TAGT', 'TGTATA', 'TAATT', 'ATTTA', 'AATTT', 'AATTA', 'TTAAT', 'TATAT', 'TAAT', 'TATA', 'TTAAAA', 'ATATTA', 'AAAATT', 'AATTAT', 'TATATT', 'TATTAA', 'TAAAAT', 'TTATTT', 'TAATTT', 'TTAATT', 'TCTAG', 'TTGCTT']
GTTCCTCCCTCAGCGATAATGTCAATGGCGGAAAACTGGACGTTGCAATGAATAACAGCGTCTGGAACGTAACAAGTAATT	['TAACA', 'ATAACA', 'AATAAC', 'TAACAA', 'TAATGT', 'GTAATT', 'GAATAA', 'GATAAT', 'ATAATG', 'AAGTAA', 'AGTAAT', 'AATAA', 'TAATT', 'ATAAT', 'ATAA', 'TAAT']
TTGGAAGCATCACCAAGAATGCGATGGATGGTATATTTACGAAAAAATAATTGATGATAATTTTGCCATAGTCATAGAATC	['TCATA', 'ATAGT', 'ATAGA', 'GTATA', 'TAGT', 'ATAG', 'ATGATA', 'GATAAT', 'ATAGAA', 'TAGAAT', 'TAATTG', 'GGTATA', 'AATAA', 'TAATT', 'ATTTA', 'ATTTT', 'AATTT', 'ATAAT', 'AAATA', 'TATAT', 'ATAA', 'TAAT', 'TATA', 'ATATTT', 'AAAATA', 'TATTTA', 'TATATT', 'AATTTT', 'ATAATT', 'TAATTT', 'AAATAA', 'AATAAT', 'CATAG', 'TCATAG', 'ATAGTC', 'CATAGA', 'CATAGT', 'TTTT']
ATTGCTGAGCAACAGGTAATTACGATTTTAGTTAAGGGTTCACGTAGTGCCGCCATGGAAGAGGTAGTACGCGCTTTACAG	['TTTACA', 'TAGTA', 'TTAGT', 'TAGTT', 'TTTAG', 'TAAGG', 'TAGT', 'GTAATT', 'TTAGTT', 'GAGGTA', 'TAAGGG', 'TTTAGT', 'TTTTAG', 'TTAAGG', 'TAGTTA', 'TAATT', 'ATTTT', 'TTTTA', 'AATTA', 'TAAT', 'ATTTTA', 'TAATTA', 'TTTT']
AGCGCTACACCACCTGAATATACAGCATCTGCGACGGTCGCATAGCCTTCGCCATGGCAGGCGTCATACCCGCAAAGGCGA	['TCATA', 'ATACA', 'TATAC', 'TATACA', 'ATATAC', 'ATAG', 'ATATA', 'TATA', 'AATATA', 'CATAG', 'ATACAG', 'GCATAG', 'CATAGC']
ACGGTCTGGGGCGGCAATCTTATTCCGGCGATTGTCATTCTCTTTGGTATAACCGTGATTTTGTGCTGGTTCGGCAACGTC	['ATCTTA', 'GTATA', 'GTATAA', 'GGTATA', 'ATTTT', 'TATAA', 'ATAA', 'TATA', 'TTGTCA', 'TTTT', 'CTCTTT', 'TTTTGT']
TATGCAGGATCTCACCTCTTTTATTGTTAATAAATTAGGGGTAGTCGATGTAGGTGCCAGTTTGCAAGGGAGAGCGGTGTA	['CTTTTA', 'TAGT', 'TTGTTA', 'AATTAG', 'AATAA', 'TAATA', 'TAAAT', 'TTTTA', 'AATTA', 'TTAAT', 'ATAA', 'TAAT', 'ATAAAT', 'TTTTAT', 'TAAATT', 'TAATAA', 'AATAAA', 'TTAATA', 'TTTT', 'CTTTT', 'CTCTTT', 'TCTTTT', 'AGGGAG']
GGGCATAACTTTTTACGCTATAGCCAACAAATTCTCGCGTTAGTGGATGAAGCGCGGAGCGTTGTCGCTGGCGATGAGCCG	['CATAA', 'CTATA', 'CATAAC', 'ACTTTT', 'TTAGT', 'TATAG', 'TAGT', 'ATAG', 'TTTTA', 'ATAA', 'TATA', 'TTTTTA', 'GCTATA', 'CTATAG', 'TTTTT', 'TTTT', 'CTTTT', 'CTTTTT']
TTTCTATATATCAGTGTTTTATGTTGGAATTTTTCCTTGTTTTTATTTTACTAGTTGGTAAACCCTGTTTATGCTGAAACA	['CTATA', 'TAGTT', 'TAGT', 'TAGTTG', 'ATATA', 'ATTTT', 'AATTT', 'TTTTA', 'TATAT', 'TATA', 'TATTTT', 'TATATA', 'AATTTT', 'TTTTAT', 'TTATTT', 'ATTTTA', 'ATTTTT', 'TTTTTA', 'ATATAT', 'ACTAG', 'CTAGTT', 'TACTAG', 'ACTAGT', 'TTTTT', 'TTTT', 'CTTGT', 'CCTTGT', 'CTTGTT', 'TTTTTC', 'GTTTTT', 'TTGTTT', 'TGTTTT']
AGGGTATAGACCCGAAACCCGGTGATCTAGCCATGGGCAGGTTGAAGGTTGGGTAACACTAACTGGAGGACCGAACCGACT	['TAACA', 'ACTAA', 'ATAGA', 'TATAG', 'GTATA', 'ATAG', 'GTATAG', 'TATAGA', 'GGTATA', 'TATA', 'TCTAG', 'ATAGAC', 'ATCTAG', 'CTAGCC']
TAATGTTTGAGGATCGCCCAGATGAATCGCTCACCCGATAAAATCATCGCGCTGATATTTTTACTGATTAGCCTGTTGGTG	['AATCAT', 'TAATGT', 'ATTTT', 'TTTTA', 'ATAA', 'TAAT', 'ATATTT', 'TATTTT', 'TAAAAT', 'ATTTTT', 'ATAAAA', 'TTTTTA', 'TTTTT', 'TTTT']
AGCCCGGTTGGCTGTCTGTTTTATGATTTTTTCGGCGGGAATACTCTTAAGGCTGATGTCTCTATTTCGGTCACCGAGCTT	['ATACT', 'ATACTC', 'TCTTAA', 'ACTCTT', 'TAAGG', 'TATGAT', 'TTAAGG', 'ATTTT', 'TTTTA', 'TTTTAT', 'ATTTTT', 'TTTTT', 'TTTT', 'TTTTTT', 'TTTTTC', 'TGTTTT']
AAACTATTCATCTTAATTTTGCTGACACCCGCGCTCATTTACAGCTCAATGATATGATTTCCGCCCTGGAAGACATCATTA	['ATTCAT', 'TTTACA', 'AAACTA', 'ATCTTA', 'CTTAAT', 'TCATTT', 'TCTTAA', 'ATGATA', 'TATGAT', 'TAATT', 'ATTTA', 'ATTTT', 'AATTT', 'TTAAT', 'TAAT', 'AATTTT', 'TAATTT', 'TTAATT', 'AGACAT', 'TTTT']
GTAAACTCGGTGTGCGTGAACTGGTGACCTTGCTTGAGCAAACAGTGGTGAATACCCTGGCTGAACTGGGTATAGAAGCGC	['ATAGA', 'TATAG', 'GTATA', 'ATAG', 'ATAGAA', 'GTATAG', 'TATAGA', 'GGTATA', 'TATA', 'TTGCTT']
CATAGCGTCGATTTTCATGAAATAGAAGAGTGCCAGCGTCGCGGGGAATGGGATAAAACCGGGGACATTCTGGCTGAGGCG	['TTTCAT', 'TTTTCA', 'AATAG', 'ATAGA', 'ATAG', 'ATAGAA', 'AATAGA', 'AAATAG', 'ATTTT', 'AAATA', 'ATAA', 'ATAAAA', 'CATAG', 'CATAGC', 'TTTT']
AGTGGTCGGTATACGCCTTAATTGTCGCGACTATTATTGGCCTGGGTGTACTGGCAAAAATTTATCGCAAAGCAGAAAACC	['TATAC', 'CTATTA', 'CTTAAT', 'GTATA', 'AATTGT', 'TAATTG', 'GGTATA', 'TAATT', 'ATTTA', 'AATTT', 'TTAAT', 'TAAT', 'TATA', 'AAAATT', 'AAATTT', 'TATTAT', 'AATTTA', 'TTAATT']
GGAAGGTATCAGTGCTTCTTATATTGTAAAGCATTGGCCTAGGAAGGCAAACAGTTGTCTTTTTGAAGGATTTTTTTCTGC	['CTTATA', 'TTCTTA', 'TGTAA', 'TAGGAA', 'TGTAAA', 'TTGTAA', 'ATTTT', 'TTATA', 'TATAT', 'TATA', 'TTATAT', 'TATATT', 'ATTTTT', 'TTTTT', 'TTTT', 'TTTTTT', 'CTTTT', 'TCTTTT', 'TTTTTC', 'CTTTTT', 'TTTTCT', 'TTTTTG']
GCTGGGTCTGGATGCCTTCGTGCTGTTTAAAAATCCACGCATGGCCATCTTTTTCCTCTTTGCCATGATGCTGGGTGCGGT	['TTAAAA', 'TAAAAA', 'TTTAAA', 'TTTTT', 'TTTT', 'CTTTT', 'CTCTTT', 'TCTTTT', 'TTTTTC', 'CTTTTT']
GACTCCCGTATTGCATTGCCTTCTATCTCCGGGAGTCATAAGGCGGAAATTAATGCCGCAATTGATTCGCTGGATGCCGAA	['TCATA', 'CATAA', 'TCATAA', 'TAAGG', 'AATTA', 'TTAAT', 'ATAA', 'TAAT', 'ATTAAT', 'AATTAA', 'CATAAG', 'TTGCAT']
CAAACGCTGACCGAAGAAGCGGTGCGTCTGTATGGCGATAAGCTGACTAATGCCAACGTAGTTGATGATGTTATCGACTTT	['ACTAA', 'ACTAAT', 'TAGTT', 'TAGT', 'TGTTAT', 'ATGTTA', 'TAGTTG', 'ATAA', 'TAAT', 'GACTAA']
GTCGATAAGGGTGGTTGTATTAACGTACTGACCACTCAACGTCCGTCTCCTCTCGCTAAGGGGAATCCGTCACATACAAAC	['TCACA', 'ATACA', 'ACATA', 'ACATAC', 'CACATA', 'TCACAT', 'ATACAA', 'TAAGG', 'TAAGGG', 'ATAA', 'TATTAA', 'CTAAGG']
AACGGTGGATCAATATTGGGCCGTTGGTGGAGATATAAGTGGATCACTTTTCATCCGTCGTTGACAACCACTGATGGGCAA	['TTTCAT', 'ACTTTT', 'TTTTCA', 'TATAAG', 'GATATA', 'ATAAGT', 'ATATA', 'TATAA', 'ATAA', 'TATA', 'ATATAA', 'AATATT', 'TTGACA', 'TTTT', 'CTTTT', 'CTTTTC']
CATAAAATTAGCCATGATGTTTTTGAACCTTATCCCGCGGCGTTACATGGTCAATTTGATTCCATTTCCATGTCTTACCTT	['CATAA', 'CATAAA', 'TTACAT', 'CAATTT', 'TCAATT', 'AATTAG', 'AATTT', 'AATTA', 'ATAA', 'AAAATT', 'TAAAAT', 'ATAAAA', 'TTTTT', 'TTTT', 'GTTTTT', 'TGTTTT', 'TTTTTG']
TTTGTTGGCGGTTTTCATTATTGCGGCGTCGGTTGTGACTCGCGCGACCATCGGCGGCGTTATAGAACAGTACAATATTCC	['ACAAT', 'TACAAT', 'ACAATA', 'TTTCAT', 'TTTTCA', 'TTCATT', 'ATAGA', 'TATAG', 'ATAG', 'GTTATA', 'TTATAG', 'ATAGAA', 'TATAGA', 'TTATA', 'TATA', 'AATATT', 'TTTT', 'TTTGTT']
CCTGCTCGTCATTCATCGACTTAATGGACGCAAAAAAGGCCGGTTAAACCGACCTTTTATCCAGCCGCCCTTCAGGGCGTG	['ACTTA', 'ACTTAA', 'ATTCAT', 'CTTAAT', 'CTTTTA', 'TTTTA', 'TTAAT', 'TAAT', 'TTTTAT', 'TTTT', 'CTTTT', 'CCTTTT']
CCCTGTTACCAAAAACGCTTTTCACGACCGGTTATCGCTACACTAAATATTACGATGATGTCGAAGTCGATGCCTGGCAAG	['ACTAA', 'ACTAAA', 'CTAAAT', 'TTTTCA', 'TACACT', 'TAAAT', 'AAATA', 'TAAATA', 'ATATTA', 'AATATT', 'AAATAT', 'TTTT', 'CTTTT', 'CTTTTC']
ACCCAACTGGACGTTTTAATGACCTCGTTAAACAGCACCAGCAGCTACTTAACGCAGCAGTTCGAAAACAACAGTAATTCC	['ACTTA', 'ACTTAA', 'TACTTA', 'TAATTC', 'GTAATT', 'AGTAAT', 'TAATT', 'TTTTA', 'TTAAT', 'TAAT', 'TTTAAT', 'TTTTAA', 'TTTT']
ATACAGTTGCTTTCGAGGATGTCGACAAAATAATTGGGGGTTACGATTTCATCCTTTGCTCTAATGTTCTCTCTGCCGTTC	['ATACA', 'ATTTCA', 'TTTCAT', 'TCTAAT', 'TAATGT', 'TAATTG', 'AATAA', 'TAATT', 'ATAAT', 'AAATA', 'ATAA', 'TAAT', 'AAAATA', 'ATAATT', 'AAATAA', 'AATAAT', 'ATACAG', 'TTGCTT']
AGCCCGTCGGCGGAACTGTTTTATGAAGACCTTGATGAAGCTGATAACATTGAGGTAATCCGCAAATTGCTGGATACACTC	['TAACA', 'ATACA', 'ATAACA', 'TAACAT', 'TACACT', 'GAGGTA', 'TTTTA', 'ATAA', 'TAAT', 'TTTTAT', 'GATACA', 'TTTT', 'TGTTTT']
TTGCCGATGACGCAAGATTTGTTTTAAATGCGGGGAAAAAGAAATTTACCGGCACAATATCGCTTTACTACTACTGGAATA	['ACAAT', 'ACAATA', 'TAAAT', 'ATTTA', 'AATTT', 'TTTTA', 'TTAAAT', 'AAATTT', 'AATTTA', 'TTTAAA', 'TTTTAA', 'TTTT', 'TTGTTT', 'TTTGTT', 'TGTTTT']
TAAACCGCTTTTTCTCTAATGCGTTTACTTTTGCTCGTCGGTTTTACGACCAATTACCCGTTAAATTTGATCATGACTGGT	['CAATTA', 'ACTTTT', 'TCTAAT', 'TAAAT', 'AATTT', 'TTTTA', 'AATTA', 'TAAT', 'TTAAAT', 'AAATTT', 'TAAATT', 'TTTTT', 'TTTT', 'CTTTT', 'TTTTTC', 'CTTTTT', 'TTTTCT']
TTAGAAATTATAGTTTATCTGACAAAAATAACAGCCAGCCAATATGTTTTTTCCTTGGTCGTGATAAAGGGCGTCTTCAAA	['TAACA', 'ATAACA', 'AATAAC', 'TTAGA', 'ATAGT', 'TAGTT', 'TATAG', 'TAGT', 'ATAG', 'TAGTTT', 'TTATAG', 'ATAGTT', 'TATAGT', 'AATAA', 'TTATA', 'AATTA', 'AAATA', 'ATAA', 'TATA', 'AAAATA', 'AATTAT', 'ATTATA', 'AAATAA', 'TTTTT', 'TTTT', 'TTTTTT', 'TTTTTC', 'GTTTTT', 'TGTTTT']
TCATTTTTACACTCACGTAAGGGCAGTGAAGACAACTGTCGTGAGGTAGCCGCAGCGGTACGTGATGCTGGAGGTTGGGTG	['TTTACA', 'TCATTT', 'TACACT', 'TAAGG', 'GAGGTA', 'TAAGGG', 'ATTTT', 'TTTTA', 'ATTTTT', 'TTTTTA', 'TTTTT', 'TTTT']
GCGCGGCGAAGAATTTAAGCAATTTTGCCAGTCTTGGTAGCGAATGCACCGTTGACCGTGAATTAAAGGCGCTGGCACAAG	['CAATTT', 'TTTAAG', 'AGAATT', 'ATTTA', 'ATTTT', 'AATTT', 'AATTA', 'AATTTT', 'AATTTA', 'ATTTAA', 'AATTAA', 'TTTT']
CTGTATACCCTGTTCCTGGTGGCAGAATTGTTCTTAATGTTCAAGTTTGCACGCCTCGGCCCAAGCAGCCTGAAAACCGGT	['TATAC', 'CTTAAT', 'TCTTAA', 'TTCTTA', 'GTATA', 'TAATGT', 'AATTGT', 'AGAATT', 'TGTATA', 'TTAAT', 'TAAT', 'TATA', 'TCAAGT']
GAGCGGGTTCAAGACTTTTGTTATCGCATTGGCTCGATTCTGCTGGTGCTGTTAATGGGGCTTGCACTTTTCAATGATTTC	['ACTTTT', 'TTTTCA', 'TGTTAT', 'TTGTTA', 'TTAAT', 'TAAT', 'TTTT', 'CTTTT', 'CTTTTC', 'TTTTGT', 'TTTGTT']
GTAGCCCATATCTTTAAAAACCCGCCTTACTGGGCGGGTTTTTTATGGGTAGCGTTAGCGTACAAGACAATATGTTTAGTC	['ACAAT', 'ACAATA', 'TATCTT', 'TTAGT', 'TTTAG', 'TAGT', 'TTTAGT', 'TTTTA', 'TTAAAA', 'TTTTAT', 'TAAAAA', 'TTTAAA', 'TTTTTA', 'TTTTT', 'TTTT', 'TTTTTT', 'GTTTTT']
CTGCATTGGTTTAATAAAAACCATCAACAATTGTGATTTAGATATTCGGAACCATTCAAATATAACAAAACCCCGTAAAAA	['TAACA', 'ACAAT', 'ATAACA', 'ACAATT', 'CAAATA', 'AACAAT', 'TCAAAT', 'TAACAA', 'TAGAT', 'TTAGA', 'TTTAG', 'ATTTAG', 'TTTAGA', 'AATTGT', 'TTAGAT', 'AATAA', 'ATATA', 'TAATA', 'ATTTA', 'TTAAT', 'AAATA', 'TATAA', 'ATAA', 'TAAT', 'TATA', 'AATATA', 'ATATAA', 'TAAAAA', 'TAATAA', 'ATAAAA', 'AAATAT', 'TTTAAT', 'AATAAA', 'TTAATA']
GTGAAGCTTATTGCCGAAACCGCGCCTGACGCTAATAACCTGTTACGTCAGTATGTTGCTTTTGCCAGCCAGCGTGCAGCC	['CTAATA', 'AATAAC', 'AATAA', 'TAATA', 'ATAA', 'TAAT', 'TAATAA', 'TTTT', 'TTGCTT', 'CTTTT']
TCCCCGATTTTGACTGGGCACGTTATACCTCTGGCATCGTGCTGGCGTTAGTTTCCGTGGTCTGCTGGGCGTGGTATGCCC	['TATAC', 'TTATAC', 'TTAGT', 'TAGTT', 'TAGT', 'TAGTTT', 'GTTATA', 'TTAGTT', 'ATTTT', 'TTATA', 'TATA', 'TTTT']
TTAAGCTAGCTAAAAATGCCAATAAAGTAAATAAAAAACTTGTATTACCTGACGAATATATAGCACTTGAATTTAAAGGTA	['CAATAA', 'TATAG', 'ATAG', 'AAGTAA', 'ATATAG', 'AATAA', 'ATATA', 'TAAAT', 'ATTTA', 'AATTT', 'AAATA', 'TATAT', 'ATAA', 'TATA', 'AATATA', 'TAAATA', 'TATATA', 'AATTTA', 'ATTTAA', 'TAAAAA', 'ATAAAA', 'TTTAAA', 'AAATAA', 'AATAAA', 'ATATAT', 'ATAGCA', 'TAGCTA', 'CTTGT']
TATGCGGCTAATTCCGCGGCCGTGATGGAGCTGTTGTTCACTAACCGTGTCTTTTTAATCGGTCTGATCATCGCGCAATTA	['ACTAA', 'CTAATT', 'CAATTA', 'TAATTC', 'TAATT', 'TTTTA', 'AATTA', 'TTAAT', 'TAAT', 'TTTAAT', 'TTTTAA', 'TTTTTA', 'TTTTT', 'TTTT', 'CTTTT', 'TCTTTT', 'CTTTTT']
GGGAAGAGCCATGACTGCGGTAATAAATTAGGTTACATGCAGGCCTTCGTTGAATACGGTATTCGTCATAACACCCTTGGC	['TCATA', 'CATAA', 'TAACA', 'ATAACA', 'TCATAA', 'CATAAC', 'TTACAT', 'AATTAG', 'AATAA', 'TAATA', 'TAAAT', 'AATTA', 'ATAA', 'TAAT', 'ATAAAT', 'TAAATT', 'TAATAA', 'AATAAA']
GCTTGCGAAACCTACGTAAAAACCGGCATGGTTTTAGTTGGCGGCGAAATCACCACCAGCGCCTGGGTAGACATCGAAGAG	['TTAGT', 'TAGTT', 'TTTAG', 'TAGT', 'TTAGTT', 'TTTAGT', 'TTTTAG', 'TAGTTG', 'TTTTA', 'TAAAAA', 'TAGACA', 'AGACAT', 'TTTT']
AGTGGGAAACGATGTGGGAAGGCCCAGACAGCCAGGATGTTGGCTTAGAAGCAGCCATCATTTAAAGAAAGCGTAATAGCT	['TCATTT', 'AATAG', 'TTAGA', 'ATAG', 'TAATAG', 'TAATA', 'ATTTA', 'TAAT', 'ATTTAA', 'TTTAAA', 'CTTAGA', 'AATAGC']
TGTGATCCAGAGGCTGGGTGACAAACGTATAATTGCCTGATGCGCTTCGCTTATCAGGCCTACATAAGGCATTGCAACTGA	['CATAA', 'ACATA', 'ACATAA', 'TACATA', 'GTATA', 'TAAGG', 'GTATAA', 'TAATTG', 'TAATT', 'ATAAT', 'TATAA', 'ATAA', 'TAAT', 'TATA', 'TATAAT', 'ATAATT', 'CATAAG']
TCCTGAATGCCGCTGGAACCAAAACCGGAAAAGTTTTCCCGACTGATAATCAGATTGATTATTTTGACGATGTCCCGGTGA	['TAATCA', 'ATAATC', 'GATAAT', 'ATTTT', 'ATAAT', 'ATAA', 'TAAT', 'TATTTT', 'TTATTT', 'TTTT']
AATGGAGATTGTGGAGATTGCACGTCAGCATAATCTCATTATCTTCGCCGATGAAATTTATGACAAAATTCTCTACGACGA	['CATAA', 'CATAAT', 'TATCTT', 'ATAATC', 'ATTTA', 'AATTT', 'ATAAT', 'ATAA', 'TAAT', 'AAAATT', 'AAATTT', 'AATTTA']
AAGAGGGTTGATGCCAGCATACAGGGGCGAAGCTGGTCAACAAGTCAACATTAAGATAATGGAATATTCGGAGAGAAACGT	['ATACA', 'TAAGAT', 'TTAAGA', 'GATAAT', 'ATAATG', 'ATAAT', 'ATAA', 'TAAT', 'AATATT', 'ATACAG', 'GAGAGA']
CTTGATTACATTGAAGGAAACATAAAGAAAAAATCATGGCTGGATAACAAAGAATTATTACAAACAGCGATATCAGTTCTT	['CATAA', 'TAACA', 'ACATA', 'ACATAA', 'AATCAT', 'ATAACA', 'CATAAA', 'TTACAT', 'AACATA', 'TAACAA', 'AGAATT', 'AATTA', 'ATAA', 'AATTAT', 'TTATTA']
CTGGCAATTACCCTCGACGTACCGGAAGATACTGACATTTATATGCCCATGGTTTCTCGACTTGCACAGCTGACCGTGATA	['ATACT', 'CAATTA', 'ACATTT', 'ATTTA', 'TTATA', 'AATTA', 'TATAT', 'TATA', 'TTTATA', 'TTATAT', 'ATACTG']
GGCTACGATGAGAAAACCCTGCCAGCCAGTGCGCCGAAAAATGGCCACTATAAAGCTTATATTCTGGGTGAAGGGCCAGAT	['CTATA', 'CTATAA', 'CTTATA', 'TTATA', 'TATAA', 'TATAT', 'ATAA', 'TATA', 'TATAAA', 'TTATAT', 'TATATT']
TGTTATAGCCAGCATCTGCGCGGCTTAATTCGTACTCGCGTGCAGCAACTGGTTTCTGAGTGTATTGAATTGCGTCTTTCC	['CTTAAT', 'TAATTC', 'TATAG', 'ATAG', 'TGTTAT', 'GTTATA', 'TTATAG', 'TAATT', 'TTATA', 'TTAAT', 'TAAT', 'TATA', 'TTAATT']
AATATCCTGGGTTCAAAACCCGGAACGATCTTCACTATGTTAAGGGATACTGGCGGCATAAAACCCCATGAGCGTAAGCGG	['CATAA', 'ATACT', 'CATAAA', 'TAAGG', 'ATGTTA', 'TAAGGG', 'TTAAGG', 'ATAA', 'ATAAAA', 'ATACTG']
GCCGCCATCCTGCCGACCCCTGCGTTTGCAACACTCTCTACCCCACGCCCGCGCATTTTGACACTCAATAATCTTCATACC	['TCATA', 'CAATAA', 'ATAATC', 'TTCATA', 'AATAA', 'ATTTT', 'ATAAT', 'ATAA', 'TAAT', 'AATAAT', 'TTGACA', 'TTTT', 'CCCCAC']
AAATTCAGAGATAACTTGAAGCGGGTCAAAGAAGCGCTGAAGGAATCGCGTTTTGATAAGCAGTTACTTAATTTAAGTGAC	['ACTTA', 'ACTTAA', 'TACTTA', 'CTTAAT', 'TTTAAG', 'TAATT', 'ATTTA', 'AATTT', 'TTAAT', 'ATAA', 'TAAT', 'AATTTA', 'ATTTAA', 'TAATTT', 'TTAATT', 'TTTT']
TTTTTGTTGTGGGGATCGCATGCGCAAAAGAAAGGGGCGATTATAGATAAGCAACGCCATCATGTACTGAAAGCACCGCAT	['TAGAT', 'ATAGA', 'TATAG', 'ATAG', 'TTATAG', 'ATAGAT', 'TATAGA', 'TTATA', 'ATAA', 'TATA', 'ATTATA', 'TTTTT', 'TTTT', 'TTTTGT', 'TTTGTT', 'TTTTTG']
TAATTACGCCGTTGCGTCGTTAGGTACGTCAACCACCGCCGATCACATACAACTGTTGTTCCGCGCGACCAACAATGTCAT	['ACAAT', 'TCACA', 'ATACA', 'ACATA', 'ACATAC', 'CACATA', 'AACAAT', 'TCACAT', 'ATACAA', 'ATCACA', 'TAATT', 'AATTA', 'TAAT', 'TAATTA']
CAGACCTTTTTTGTCGCCCTCGCCATTGGCTCTATGCTGTGGTGGCCGAACCGCAAAGAGAAAGGCGAACTTAAATCCCGT	['ACTTA', 'ACTTAA', 'TAAATC', 'CTTAAA', 'AACTTA', 'TAAAT', 'TTAAAT', 'TTTTT', 'TTTT', 'TTTTTT', 'CTTTT', 'CCTTTT', 'CTTTTT', 'TTTTGT', 'TTTTTG']
AACGAATGTGAAACTTATGCTGAATTAAAATTGGGTCAGGAAGTGTGGAAAGAGGGCGATAAGAGCTTCTATTTCGACACT	['ACTTA', 'AACTTA', 'TAAGAG', 'ATAAGA', 'AATTA', 'ATAA', 'TTAAAA', 'AAAATT', 'TAAAAT', 'AATTAA']
ATAAATTAGCAGCGATTGCCGCCCCCGCAGAAATCTTTTTACTCGAAGATGGGATTGATGGCTGGAAAAAAGCAGGATTGC	['AATTAG', 'TAAAT', 'TTTTA', 'AATTA', 'ATAA', 'ATAAAT', 'TAAATT', 'TTTTTA', 'TTAGCA', 'CCCCC', 'TTTTT', 'TTTT', 'CTTTT', 'TCTTTT', 'CTTTTT', 'CCCCCG']
GTGGTTTTTGGCCTTGCCCTGCATACCATTTATGGTTCTGACAGCCAGGTACTTAAAGATTCTGTACAGTGGTTTAACATC	['ACTTA', 'TAACA', 'ACTTAA', 'TACTTA', 'TTAACA', 'CTTAAA', 'TAACAT', 'ATTTA', 'TTTTT', 'TTTT', 'GTTTTT', 'TTTTTG']
CGAAGGCGCAGCGTTGCTGTTCAGCGGCAGGATCTGTGATGACTTACCCGGCGGCGCATTTCTTTATACTAATCAACAAAC	['ACTTA', 'ACTAA', 'ATACT', 'TATAC', 'TATACT', 'TAATCA', 'ATACTA', 'TTATAC', 'ACTAAT', 'TACTAA', 'TTATA', 'TAAT', 'TATA', 'TTTATA']
CCTGCTACTGGCGATGTTATTCAGCGGTATATCGAACAATTTGTTGCCAATTCCAACAAGATGACCGCCGTTGGGGCGTGC	['ACAAT', 'ACAATT', 'CAATTT', 'AACAAT', 'GTATA', 'TGTTAT', 'ATGTTA', 'GGTATA', 'AATTT', 'TATAT', 'TATA', 'TTTGTT']
ATATTGCTGCGCTAAAAATTATTGCTCGCCGTAGCGAATAATTATATGCCTGGTGTGGCTTCGTACGCCGGATAAGACGCG	['GAATAA', 'ATAAGA', 'AATAA', 'TAATT', 'ATAAT', 'TTATA', 'AATTA', 'TATAT', 'ATAA', 'TAAT', 'TATA', 'AAAATT', 'TTATAT', 'AATTAT', 'ATTATA', 'TAAAAA', 'ATAATT', 'TAATTA', 'AATAAT']
GCTAAAAATGACCATTTTTACGGGAAACATTGTGCTGATGCTGGCGCTAATGGTTTCGTGAGTAAAAAAGAAGGCATGAAC	['AAATGA', 'GAGTAA', 'ATTTT', 'TTTTA', 'TAAT', 'TAAAAA', 'ATTTTT', 'TTTTTA', 'TTTTT', 'TTTT']
TTTGTCAAATTTTTAGGTATTTAATTTGTAAAACAGTTTGCTTTGTACTGGCATACAGAAAATAGGGTATTGATTTTAAAC	['ATACA', 'TCAAAT', 'AATAG', 'ATAGG', 'TTTAG', 'TGTAA', 'ATAG', 'TTTAGG', 'TAGGGT', 'TGTAAA', 'AATAGG', 'TTGTAA', 'AAATAG', 'TTTTAG', 'TAATT', 'ATTTA', 'ATTTT', 'AATTT', 'TTTTA', 'TTAAT', 'AAATA', 'TAAT', 'AAAATA', 'AAATTT', 'TATTTA', 'AATTTT', 'ATTTAA', 'ATTTTA', 'ATTTTT', 'TAATTT', 'TTTAAA', 'TTTAAT', 'TTTTAA', 'TTTTTA', 'TTAATT', 'ATACAG', 'TTGTCA', 'TTTTT', 'TTTT', 'TTGCTT']
CGGGAAAATACGATAAACATCGCGCACGTTCTTTTTTAGCCGCCAGTTGGCATGATGATACCAGTCGCTATTCTCTGGGGG	['TTTAG', 'ATGATA', 'TTTTAG', 'TTTTA', 'AAATA', 'ATAA', 'AAAATA', 'TTTTTA', 'TTTTT', 'TTTT', 'TTTTTT', 'CTTTT', 'TCTTTT', 'CTTTTT']
GTTTGCCAAAAGTTTGGGCTATAGCAAACCGCAAACCCAGGGCGATTATGCTATCGCACAGCATTTTCTGACGAACCTGCC	['CTATA', 'TATAG', 'ATAG', 'ATTTT', 'TATA', 'ATAGCA', 'GCTATA', 'CTATAG', 'TAGCAA', 'ATGCTA', 'TTTT', 'TTTTCT']
AGGCATTAGGATTAAAATATGCTCCTGTAGATGGCGATGGATATTGTCTGTTAAGAGCTATACTGGTTTTAAAACAACATG	['ATACT', 'CTATA', 'TATAC', 'TATACT', 'TAGAT', 'TTAAGA', 'TAAGAG', 'TTAGGA', 'TAGGAT', 'TTTTA', 'AAATA', 'TATA', 'TTAAAA', 'AAAATA', 'TAAAAT', 'AAATAT', 'TTTAAA', 'TTTTAA', 'GCTATA', 'ATACTG', 'TTTT']
ACTGTTTTTTTCAACCTGTTCATATTTCATAAAGATCTGGCCACTGAGTGAGTTTTCAATCACCTTTCCATCCACCTTATA	['TCATA', 'CATAA', 'ATTTCA', 'TCATAA', 'CATAAA', 'TTTCAT', 'CTTATA', 'TTTTCA', 'TTCATA', 'TTATA', 'ATAA', 'TATA', 'ATATTT', 'TTTTT', 'TTTT', 'TTTTTT', 'TTTTTC', 'GTTTTT', 'TGTTTT']
ATGCCTTATTTTTATTGATCTGCTTTGTCTTACAATTAAGGTCCAAGAGCTTGGTTAAACTGTATTATTTGCCTAAGTATA	['ACAAT', 'TACAAT', 'ACAATT', 'CAATTA', 'GTATA', 'TAAGG', 'TAAGTA', 'TAAGGT', 'AGTATA', 'TTAAGG', 'ATTTT', 'TTTTA', 'AATTA', 'TATA', 'TATTTT', 'TATTAT', 'TTTTAT', 'TTATTT', 'ATTTTT', 'AATTAA', 'TTTTTA', 'TTTTT', 'TTTT']
AGCTGGAGCTGCCTACAGTTCATATCGACAATCTGACCGCCGCATTTGATGCAGTAAATTATTTATATGAGCAAGGGCATA	['TCATA', 'ACAAT', 'TTCATA', 'TAAAT', 'ATTTA', 'TTATA', 'AATTA', 'TATAT', 'TATA', 'TTTATA', 'TTATAT', 'AATTAT', 'TATTTA', 'TAAATT', 'TTATTT']
CTGGTACGTAACAATGGTTCAGAAGTTCAGTCATTAGATCCGCACAAAATTGAAGGTGTTCCGGAGTCTAATATCAGCCGA	['TAACA', 'ACAAT', 'CTAATA', 'AACAAT', 'TCTAAT', 'TAACAA', 'TAGAT', 'TTAGA', 'ATTAGA', 'TTAGAT', 'TAATA', 'TAAT', 'TAATAT', 'AAAATT']
CGCAGTCTTTTGCGTGGTAACAGCGCGCTGGTAGATGAGTGTGTCGCGTTTTATGAAGAACACTTCCCGGATCGCTATTTT	['TAACA', 'ACACTT', 'TAGAT', 'ATTTT', 'TTTTA', 'TATTTT', 'TTTTAT', 'TTTT', 'CTTTT', 'TCTTTT']
AGACGATGACGTCACTGCCCGGCTGTATGCGCGAGGTTACCGACTGCGGCCTGAGTTTTTTAAGTGACGTAAAATCGTGTT	['TTTAAG', 'TTTTA', 'TAAAAT', 'TTTTAA', 'TTTTTA', 'CGAGGT', 'TTTTT', 'TTTT', 'TTTTTT', 'GTTTTT']
CTGTTTCCCTCTATTGGCGGGCGAGCCTTTGAAGTGGATAATTTAGAGCAGCTGGAATTTGTTGGGCGCTTTATCGGTCGT	['TTAGA', 'TTTAG', 'GATAAT', 'ATTTAG', 'TTTAGA', 'TAATT', 'ATTTA', 'AATTT', 'ATAAT', 'ATAA', 'TAAT', 'AATTTA', 'ATAATT', 'TAATTT', 'TTTGTT']
ATTAAATCACAACTCATTACCAGCTATAGCCATAGCAAAGATTACAACTACGATCCCCATTATGGTCGTTATGATTCGTCG	['TCACA', 'CTATA', 'ACTCAT', 'TAAATC', 'TCACAA', 'ATCACA', 'TATAG', 'ATAG', 'TATGAT', 'TAAAT', 'TATA', 'TTAAAT', 'CATAG', 'ATAGCA', 'GCTATA', 'CTATAG', 'TAGCAA', 'CATAGC']
TGAACAACAATTTTATGAGACATCCAGCAAAGGCAAAATTCCTCTGTTGCAACGGTTATTAAGCTTGCATCAGCCATCCTC	['ACAAT', 'ACAATT', 'CAATTT', 'AACAAT', 'ATTTT', 'AATTT', 'TTTTA', 'AAAATT', 'TATTAA', 'AATTTT', 'TTTTAT', 'ATTTTA', 'TTATTA', 'AGACAT', 'TTGCAT', 'TTTT']
AAGGAGATCTCCCATAATATTTTTCTGCATCTGTTTGCTTTGACTGAGTAGGCGTTTTGTCATTATTGTGTATATGAGATG	['CATAA', 'CATAAT', 'CCATAA', 'GTATA', 'GAGTAG', 'TGTATA', 'TAATA', 'ATTTT', 'ATAAT', 'TATAT', 'ATAA', 'TAAT', 'TATA', 'TAATAT', 'ATATTT', 'AATATT', 'TATTTT', 'ATAATA', 'ATTTTT', 'TTGTCA', 'TTTTT', 'TTTT', 'TTGCTT', 'TTTTTC', 'TTTTCT', 'TTTTGT']
GTTTTACTCGCCTCTGAATGAGCAGAGGCGAGTGAGTATTTTAATGAACAAAACGTCCGGCACGAGACATAAATTCTTCTT	['CATAA', 'ACATA', 'ACATAA', 'CATAAA', 'AATGAG', 'TAAAT', 'ATTTT', 'TTTTA', 'TTAAT', 'ATAA', 'TAAT', 'ATAAAT', 'TATTTT', 'TAAATT', 'ATTTTA', 'TTTAAT', 'TTTTAA', 'GACATA', 'AGACAT', 'TTTT']
GGAGCATCGAGATGTTACGGATAAGCAACGAGGGGTCATATATGCTGGCAACCTTTCTAGGCATAAATGTTCTTTCATATA	['TCATA', 'CATAA', 'CATAAA', 'CATATA', 'TTTCAT', 'TTCATA', 'ATGTTA', 'ATATA', 'TAAAT', 'TATAT', 'ATAA', 'TATA', 'ATAAAT', 'ATATAT', 'TCTAG']
GTTAGAGTCATTACCGCTGTTGCTCAGTTTGCATAACTCGCCCTTTGTCATAGACGTGCTGCGTATTGTTCAGATAATGAG	['TCATA', 'CATAA', 'CATAAC', 'TTAGA', 'ATAGA', 'ATAG', 'AATGAG', 'GATAAT', 'ATAATG', 'TAGAGT', 'GTTAGA', 'ATAAT', 'ATAA', 'TAAT', 'CATAG', 'TCATAG', 'ATAGAC', 'TTGTCA', 'TTGCAT', 'CATAGA', 'CCCTTT']
AACGATGCAGGTGTTGATACCAAACAATTAGAAGGGCAAAGCGATCTCGGCTTTGCCGGTTTTCGCGTGTTTAAAGCCCCC	['ACAAT', 'ACAATT', 'CAATTA', 'AACAAT', 'TTAGA', 'ATTAGA', 'AATTAG', 'AATTA', 'TTTAAA', 'CCCCC', 'TTTT']
CTGGTAAACCATTTTCGTGAGCTGGGAAATGTTCGTTTTTATGATGAACAGGGGTTATGTGATCAGCTTTATACCCACCTC	['TATAC', 'TTATAC', 'TATGAT', 'ATTTT', 'TTTTA', 'TTATA', 'TATA', 'TTTATA', 'TTTTAT', 'TTTTTA', 'TTTTT', 'TTTT', 'GTTTTT']
TACTGAATTTGCAGTCAATGGGCGCAAGCTGTATTTGTCTCCAGTAATAGATCTCTTCAACAACGAAGTTATTTCTTACAG	['TTCTTA', 'AATAG', 'TAGAT', 'ATAGA', 'ATAG', 'ATAGAT', 'TAATAG', 'AATAGA', 'AGTAAT', 'TAATA', 'AATTT', 'TAAT', 'TTATTT']
AAAGATTTTTGTAGACCTGGTCAGGCGTTCACATGGCATCCGGCATGAACAAAGCGTACTTTGCTTAATTCAGGCTGGAAC	['TCACA', 'TCACAT', 'TTCACA', 'CTTAAT', 'TAATTC', 'TAATT', 'ATTTT', 'TTAAT', 'TAAT', 'ATTTTT', 'TTAATT', 'TTTTT', 'TTTT', 'TTGCTT', 'TTTTGT', 'TTTTTG']
TGTTACCGTTTATAACTACGATGGTGAAACACGGGAATATATTTCCACTTCAAATGAATATCTTGCCGTTGGTGTCGGCAT	['TCAAAT', 'TATCTT', 'AAATGA', 'ATATA', 'TTATA', 'TATAA', 'TATAT', 'ATAA', 'TATA', 'AATATA', 'TTTATA', 'ATATTT', 'TATATT', 'TTATAA', 'ATATAT']
CCTATTTGCCGACCGGATTGTATGTATTTGCGTATAAAAAAGATGTTTATTTGCGGGTTTGTACATTGATTATTTTCTTTG	['GTATA', 'GTATAA', 'ATGTAT', 'ATTTT', 'TATAA', 'ATAA', 'TATA', 'TATAAA', 'TATTTT', 'TAAAAA', 'TTATTT', 'ATAAAA', 'TTTT', 'TTTTCT']
TTCATTTGGGAGCAAATACTTATTGCCTTGAAAAGTAGCACTGTAATAGCCTATGATAATTAGTTGTAGAATAACCTTTAT	['ACTTA', 'ATACT', 'ATACTT', 'CAAATA', 'TACTTA', 'TCATTT', 'AATAAC', 'TTCATT', 'AATAG', 'TTAGT', 'TAGTT', 'TGTAA', 'TAGT', 'ATAG', 'ATGATA', 'TGTAAT', 'GAATAA', 'GATAAT', 'TTAGTT', 'TATGAT', 'AGAATA', 'TAATAG', 'TAGAAT', 'AATTAG', 'TAGTTG', 'AATAA', 'TAATA', 'TAATT', 'ATAAT', 'AATTA', 'AAATA', 'ATAA', 'TAAT', 'ATAATT', 'TAATTA', 'CTGTAA', 'AATAGC']
CCACAATAGTAAACTTGACTTAACAGATCTTCACTTGGGGTCTTTGCCACCTCTTCCATCCTGGATTGAGGTGCTTTATCT	['ACTTA', 'TAACA', 'ACAAT', 'ACTTAA', 'ACAATA', 'TTAACA', 'AATAG', 'TAGTA', 'ATAGT', 'TAGT', 'ATAG', 'TAGTAA', 'AATAGT', 'ATAGTA', 'CAATAG']
GCGGAGCCGCGCACGCTGATTTTTTATGAATCTACCCACCGTCTGTTAGATAGCCTGGAAGATATCGTTGCGGTATTAGGC	['TAGAT', 'TTAGA', 'ATAG', 'TTAGAT', 'GTTAGA', 'ATTTT', 'TTTTA', 'TTTTAT', 'ATTTTT', 'TTTTTA', 'TTTTT', 'TTTT', 'TTTTTT']
GAATAAAGCAGGTATTCCGTGGGCCATTGTGACTTCTGGCTCCATGCCGGTAGCGCGAGCGCGCCATAAAATAGCTGGGCT	['CATAA', 'CATAAA', 'CCATAA', 'AATAG', 'ATAG', 'GAATAA', 'AAATAG', 'AATAA', 'AAATA', 'ATAA', 'AAAATA', 'TAAAAT', 'ATAAAA', 'AATAAA', 'AATAGC']
ATAAAGCCAGTATTCTCAAATCATTTTGCGCGATATTTCGGAATCCGCCATTGCTGGTTTTATGCATTGCTAACTTGTGTA	['AATCAT', 'TCAAAT', 'TCATTT', 'ATTTT', 'TTTTA', 'ATAA', 'ATATTT', 'TTTTAT', 'TTTT', 'CTTGT']
GAGAGTACGTTTACAGGGAAAATGCCAGCTAGCAGAATTACCTTCTGCCGGGGTGAGTTGGGAAACCGATGATAATGGCTT	['TTTACA', 'ATGATA', 'GATAAT', 'AGAATT', 'ATAATG', 'ATAAT', 'AATTA', 'ATAA', 'TAAT', 'CTAGCA']
CGCCAGAGCGGATTTTTCGGCTATAGCCTCTATATTCTGTTATTCATCATTGCCACCCTCTTGCTGTTACCAGGAAGCATA	['CTATA', 'ATTCAT', 'TATAG', 'ATAG', 'TGTTAT', 'ATTTT', 'TATAT', 'TATA', 'TATATT', 'ATTTTT', 'GCTATA', 'CTATAG', 'TTTTT', 'TTTT', 'TTTTTC']
AGAAGATTAAATTTAATATTTTGAGACAGATTCACAAAGAACTGCTGATCTCTGTACCGTTGTCTAAAAAAGGTCGTCTGG	['TCACA', 'TCACAA', 'TTCACA', 'TAATA', 'TAAAT', 'ATTTA', 'ATTTT', 'AATTT', 'TTAAT', 'TAAT', 'TAATAT', 'TTAAAT', 'ATATTT', 'AATATT', 'AAATTT', 'TATTTT', 'AATTTA', 'ATTTAA', 'TAAATT', 'TAAAAA', 'TTTAAT', 'TTAATA', 'TTTT']
AGCTACGCCTGGGATGCTGGTGCACATTGGCTTATCGCTCTTTTCCTATGCCACGCTAATTATCGCCGCCCTGTACGCGCT	['CTAATT', 'CACATT', 'TAATT', 'AATTA', 'TAAT', 'AATTAT', 'TAATTA', 'TTTT', 'CTTTT', 'CTCTTT', 'TCTTTT', 'CTTTTC']
TTTAGCGCTTTTTTACGTCTTGAACAGGGTGCAATTTTAAGCCTTTCGCCAGAGCGGTTTATTCTTTGTGATAATAGTGAA	['CAATTT', 'AATAG', 'ATAGT', 'TTTAG', 'TAGT', 'ATAG', 'TTTAAG', 'AATAGT', 'GATAAT', 'TAATAG', 'ATAGTG', 'TAATA', 'ATTTT', 'AATTT', 'TTTTA', 'ATAAT', 'ATAA', 'TAAT', 'AATTTT', 'ATTTTA', 'ATAATA', 'TTTTAA', 'TTTTTA', 'TTTTT', 'TTTT', 'TTTTTT', 'CTTTT', 'CTTTTT']
TAATAATCAGGCCAATATCGCCATCGGCGCACCCGATACACTACTGGACGGCGGCGGTATTGATTACACTGAAATTGGCGC	['ATACA', 'TAATCA', 'ATAATC', 'TACACT', 'AATAA', 'TAATA', 'ATAAT', 'ATAA', 'TAAT', 'TAATAA', 'AATAAT', 'GATACA']
GTTGGTGTATGTAAAGGATTTCCATGTAGCTGTGGTGCTAGTTATTACTGGCTACATTATATGCTAAGTGTATTTGTGTTC	['TAGTT', 'TGTAA', 'TAGT', 'TGTAAA', 'ATGTAA', 'TAGTTA', 'TTATA', 'TATAT', 'TATA', 'TTATAT', 'ATTATA', 'TTATTA', 'CTAGTT', 'ATGCTA']
CGGCAAAATCAACTGGGGCATCGGCATAGGCCTTGCGGGAAGCACTTATGATAACAACTACCCGGAAGACCAGGCAGTGAA	['ACTTA', 'TAACA', 'ATAACA', 'TAACAA', 'ATAGG', 'ATAG', 'ATGATA', 'TATGAT', 'ATAA', 'CATAG', 'ATAGGC', 'GCATAG', 'CATAGG']
TATTGAACGTGAATTGCCCAGCCAGTTTGGCGTCGGGAATACCCTTAATTTGCAACTTAACGACGAAGATTTCAGCATGGC	['ACTTA', 'ACTTAA', 'ATTTCA', 'CTTAAT', 'AACTTA', 'TAATT', 'AATTT', 'TTAAT', 'TAAT', 'TAATTT', 'TTAATT', 'TTTCAG']
TATCGCTAACCCAAACACAGTGCCGCAGAAAATTGACGGTTTTGAATGGCTGCCAATTAACTTATATATCAATGGCGATAC	['ACTTA', 'CAATTA', 'TTAACT', 'CTTATA', 'AACTTA', 'ATATA', 'TTATA', 'AATTA', 'TATAT', 'TATA', 'AAAATT', 'TTATAT', 'TATATA', 'AATTAA', 'ATATAT', 'TTTT']
ATTGCATTACAGAACAATTGGAATTAACTATTGATTATTCAGATATATTTTGGAATGAAGATCTCGATGGTTATATCAATA	['ACAAT', 'ACAATT', 'AACAAT', 'TTAACT', 'GTTATA', 'ATTGGA', 'GATATA', 'ATATA', 'ATTTT', 'TTATA', 'AATTA', 'TATAT', 'TATA', 'ATATTT', 'TTATAT', 'TATTTT', 'TATATT', 'AATTAA', 'ATATAT', 'TTGCAT', 'TTTT']
TTTTGTCGGTCTGGAGGCATTTGCCCATCTCGCCTCGGAATTTAAAAATCCAGAGCGTGATTTTCCTCGTGCTTTGATGAT	['ATTTA', 'ATTTT', 'AATTT', 'TTAAAA', 'AATTTA', 'ATTTAA', 'TAAAAA', 'TTTAAA', 'TTTT', 'TTTTGT']
GTCGTTCGCGATGTAAGTTTACAAGGCAGTACGCTGGCACTTCCCGGTTCATCGGCTGAAGGTCTGCCTGGTGAAATAAAA	['TTTACA', 'TGTAA', 'TGTAAG', 'ATGTAA', 'AATAA', 'AAATA', 'ATAA', 'ATAAAA', 'AAATAA', 'AATAAA']
CACAATAACCAGGTGCTCAACAAAGTAAAAGCGGATAAATCGCTGGAAGCCAATAACGGTCACGATGGCACATGGATCGCT	['ACAAT', 'ACAATA', 'TAAATC', 'CAATAA', 'AATAAC', 'AAGTAA', 'AATAA', 'TAAAT', 'ATAA', 'ATAAAT']
AATGGCGTAAATCAACATGTTCTGGCGATCCTCGCAGCCGATCAACAGGCCGATCTGAGCCAACTCGCCAGCCATATAGGC	['TAAATC', 'CATATA', 'ATAGG', 'TATAG', 'ATAG', 'TATAGG', 'ATATAG', 'ATATA', 'TAAAT', 'TATA', 'ATAGGC']
GATCCGAATCCAACCGGAAAATATGAGTCCATTCATTATAGATATTTCTACAGGAGAACATGATGATTATATCATACAAAC	['TCATA', 'ATACA', 'TATCAT', 'ATTCAT', 'ATACAA', 'ATCATA', 'TTCATT', 'TAGAT', 'ATAGA', 'TATAG', 'ATAG', 'TTATAG', 'ATAGAT', 'TATAGA', 'TTATA', 'AAATA', 'TATAT', 'TATA', 'ATATTT', 'AAAATA', 'TTATAT', 'ATTATA', 'AAATAT']
TCAAATGTTAACCGTACGATTGCTAACGTTCGCACAATTTTCAATAAAAAAGGCGGCAATATCGGAGCGGCAGGTTCTGTC	['ACAAT', 'ACAATT', 'CAATTT', 'TCAAAT', 'CAATAA', 'TTTTCA', 'ATGTTA', 'AATAA', 'ATTTT', 'AATTT', 'ATAA', 'AATTTT', 'TAAAAA', 'ATAAAA', 'AATAAA', 'TTTT']
GCCGTATAGAAATCCCAACAGATTGAATATCAAGAAAATGTCTCACTGCCCCAAACTTAATCCCCAATAATATTCCCCCTT	['ACTTA', 'ACTTAA', 'CAATAA', 'CTTAAT', 'AACTTA', 'ATAGA', 'TATAG', 'GTATA', 'ATAG', 'ATAGAA', 'GTATAG', 'TATAGA', 'AATAA', 'TAATA', 'ATAAT', 'TTAAT', 'ATAA', 'TAAT', 'TATA', 'TAATAT', 'AATATT', 'ATAATA', 'AATAAT', 'CCCCC', 'CCCCTT', 'TCCCCC']
GGGACAGACCCTGACCATATTTTTGAAATTTTACTTGAAGCTGAAGTTGATGTTCGTGATGTGACTGAAGAAGAAGGTAAC	['ATTTT', 'AATTT', 'TTTTA', 'ATATTT', 'AAATTT', 'TATTTT', 'AATTTT', 'ATTTTA', 'ATTTTT', 'TTTTT', 'TTTT', 'TTTTTG']
TGGATCTGATAATTACCGGCTGCCAAAGCAGCGAAGGGCAGAATGGGCAAACGCCATTTTTGCTGGCGGAAATGCTGGGCT	['GATAAT', 'TAATT', 'ATTTT', 'ATAAT', 'AATTA', 'ATAA', 'TAAT', 'ATTTTT', 'ATAATT', 'TAATTA', 'TTTTT', 'TTTT', 'TTTTTG']
TGCGATGTGATAGCTGATATACCCAACGTAATTGGCGTTGCATACAGCACAACCCGCGGGCTCCAATGAACTGACCCACGC	['ATACA', 'TATAC', 'ATATAC', 'ATAG', 'GTAATT', 'GATATA', 'TAATTG', 'ATATA', 'TAATT', 'TAAT', 'TATA', 'ATACAG', 'TTGCAT']
GTGCATTTTCTTTCGATGTGACTCATTCCAATGTTCGTATCCCGGATGATAAAACATACCAGGGGCAAAGTTATCGTGTTT	['ACATA', 'ACTCAT', 'ACATAC', 'AACATA', 'ATGATA', 'ATTTT', 'ATAA', 'ATAAAA', 'TTTT', 'TTTTCT']
AAATTTTGATCCAGTAAGCACGGTTTTGGCCTTTTCGCCATTCTGTTGGCTCGGTTATTAGCATCAACAGCTTTGTAATAG	['AATAG', 'TGTAA', 'ATAG', 'TGTAAT', 'TAATAG', 'TTGTAA', 'TAATA', 'ATTTT', 'AATTT', 'TAAT', 'AAATTT', 'AATTTT', 'TTATTA', 'TAGCAT', 'TTAGCA', 'TTTT', 'CTTTT', 'CCTTTT', 'CTTTTC']
TCAGCGAATTTCAAACTACCCTTGATGCACTTGATAGTGTGATAGCGTCGCGCCTGATGCAGATGGCGCTGGAGGCGGCAC	['ATTTCA', 'AAACTA', 'AATTTC', 'ATAGT', 'TAGT', 'ATAG', 'GATAGT', 'TAGTGT', 'ATAGTG', 'AATTT']
TCCCGTCCGATTGACGTCAGCCGTTATGGTGTAATTTACGCTGGCGCGCAGAAAAATATCGGCCCGGCTGGCCTGACAATC	['ACAAT', 'TGTAA', 'GTAATT', 'TGTAAT', 'TAATT', 'ATTTA', 'AATTT', 'AAATA', 'TAAT', 'AAAATA', 'AATTTA', 'AAATAT', 'TAATTT']
TATTTCCACTATTTTTATTCGCACCGCGTTTCGTCAGCATCCCGATAAAGCGCAGGAAGTGCTGGCTACCGCTAATGAAGT	['ATTTT', 'TTTTA', 'ATAA', 'TAAT', 'TATTTT', 'TTTTAT', 'ATTTTT', 'TTTTTA', 'TTTTT', 'TTTT']
GCATGCCGTTTACCTGACCGTAGGACTGTTCGTGATTACTTTTTTTAATCCGGGAGCCAATCTCTTTGTGGTAGTACAAAC	['ACTTTT', 'TAGTA', 'TAGT', 'TTTTA', 'TTAAT', 'TAAT', 'TTTAAT', 'TTTTAA', 'TTTTTA', 'TTTTT', 'TTTT', 'TTTTTT', 'CTTTT', 'CTCTTT', 'CTTTTT']
GCGCGATTTAGACCGGGATACTGCGCGCGGTCTGTATGCTCATATGCTCAATGGTGAAGTCCCTGACCTTGAGTTGGGCGG	['TCATA', 'ATACT', 'CTCATA', 'TTAGA', 'TTTAG', 'ATTTAG', 'TTTAGA', 'ATTTA', 'ATACTG', 'TTAGAC']
TATTTTGTCCCTTTAATTATAAAGCAGAGTTATGTTTAAGCTCTGCTTTATTTATTTGAGTATTAATTCATACCGTTTTTT	['TCATA', 'ATTCAT', 'TAATTC', 'TTCATA', 'TTTAAG', 'TAATT', 'ATTTA', 'ATTTT', 'TTATA', 'AATTA', 'TTAAT', 'TATAA', 'ATAA', 'TAAT', 'TATA', 'TATAAA', 'AATTAT', 'TATTTA', 'TATTTT', 'ATTAAT', 'TATTAA', 'ATTATA', 'TTATTT', 'TTATAA', 'TAATTA', 'TTTAAT', 'TTAATT', 'TTTTT', 'TTTT', 'TTTTTT', 'CCCTTT', 'TCCCTT', 'GTTTTT', 'TTTTGT']
TATTCTACTCTGGAAGTAGAGTATTAATTATATTACTGGGAAGCCTTAACGCCATTATATTTATTTAATTGATGACATTAG	['ATTCTA', 'TAATTG', 'TAGAGT', 'TAATT', 'ATTTA', 'TTATA', 'AATTA', 'TTAAT', 'TATAT', 'TAAT', 'TATA', 'ATATTA', 'ATATTT', 'TTATAT', 'AATTAT', 'TATTTA', 'ATTAAT', 'TATATT', 'TATTAA', 'ATTATA', 'ATTTAA', 'TTATTT', 'TAATTA', 'TTTAAT', 'TTAATT']
AAAGTGGCAATTACGCATAGTTTCCCGATAAAGACGCGATAGCGACATCCCGCATAAGGCATTTTTCTCTTTATCTTTGTA	['CATAA', 'CAATTA', 'TATCTT', 'ATAGT', 'TAGTT', 'TAAGG', 'TAGT', 'ATAG', 'TAGTTT', 'ATAGTT', 'ATTTT', 'AATTA', 'ATAA', 'ATTTTT', 'CATAG', 'CATAAG', 'GCATAG', 'CATAGT', 'TTTTT', 'TTTT', 'CTCTTT', 'TTTTTC', 'TTTTCT']
TCAGCGTTCGCTGGAGCGTGGCATTAAATTACCGCCAGTCGTTCCTGCCGGACCAAATAACCCGCTAGGACGTTACGCACT	['CAAATA', 'AATAAC', 'AATAA', 'TAAAT', 'AATTA', 'AAATA', 'ATAA', 'TTAAAT', 'TAAATT', 'AAATAA']
TTCATTCGCACGGGCTTTAATGAGTAAACCGTACATTAAATGAATACCTTCGGGATAGGGAAAAGTTAACGTTGTCGGGTT	['TTCATT', 'ATAGG', 'ATAG', 'AAATGA', 'GAGTAA', 'AATGAG', 'TAGGGA', 'TAAAT', 'TTAAT', 'TAAT', 'TTAAAT', 'TTTAAT']
GGTAGTCTGGCTGCTTTGCTGGAAGGGCTGGGATTTGGTGAGCGTTTCGTGCGCACCGCTTTGTTTCGTCTTAATAAAGAA	['CTTAAT', 'TCTTAA', 'TAGT', 'AATAA', 'TAATA', 'TTAAT', 'ATAA', 'TAAT', 'TAATAA', 'AATAAA', 'TTAATA', 'TTGTTT', 'TTTGTT']
AAAAGAATGATTTATAGGGCCAGAATTAAGGGGCAAAGACATGAAAAAGCCGTTGCCCCTTTAGTCGTTATACCGTTTGAG	['TATAC', 'TTATAC', 'TTAGT', 'ATAGG', 'TATAG', 'TTTAG', 'TAAGG', 'TAGT', 'ATAG', 'GTTATA', 'TTATAG', 'AGAATT', 'TAAGGG', 'TTTAGT', 'TATAGG', 'TTAAGG', 'ATTTA', 'TTATA', 'AATTA', 'TATA', 'TTTATA', 'AATTAA', 'AGACAT', 'CCCCTT', 'CCCTTT']
TTGCTGAATCTGGCAAACACCACTGACGGTAACGGGCGCTACATTTTTGCCGGTTATAAAACAGAGACTGCGCCGTTTAGC	['ACATTT', 'TTTAG', 'GTTATA', 'ATTTT', 'TTATA', 'TATAA', 'ATAA', 'TATA', 'TATAAA', 'ATTTTT', 'ATAAAA', 'TTATAA', 'TTTTT', 'TTTT', 'TTTTTG']
TTTTCATAATTTATGTCAACGTGCGGCTACGGCGGCGGGCTATCCAGATTTCCAGCCAGATGCTTGTCTTATCAACCGCTA	['TCATA', 'CATAA', 'TCATAA', 'CATAAT', 'TTTCAT', 'TTTTCA', 'TTCATA', 'TAATT', 'ATTTA', 'AATTT', 'ATAAT', 'ATAA', 'TAAT', 'AATTTA', 'ATAATT', 'TAATTT', 'TTTT', 'CTTGT', 'CTTGTC']
CTTTTTCCCGCAGTATCATCCCGTCACGACGTTTAATAGTGGGCTTAGTGGCGGGAGTTTTCTCATTGAACATCAGGGCCA	['TATCAT', 'AATAG', 'TTAGT', 'ATAGT', 'TAGT', 'ATAG', 'AATAGT', 'TAATAG', 'ATAGTG', 'TAATA', 'TTAAT', 'TAAT', 'TTTAAT', 'TTAATA', 'CTTAGT', 'TTTTT', 'TTTT', 'CTTTT', 'TTTTTC', 'CTTTTT', 'TTTTCT']
GGTATATGACCAGGATGATGCGTTTCTTGATATTAAAGCAAACGTGCAGGCTGGACGCTTTACCGGGCTTAAGAAATTAGT	['TTAGT', 'GTATA', 'TAGT', 'TTAAGA', 'AATTAG', 'GGTATA', 'AATTA', 'TATAT', 'TATA', 'ATATTA', 'TATTAA']
GCCGTCATGACATGAAAGTGGGGCTGATCCTTAACCCGGAGACGCCAGTTGAGGCCATGAAATACTATATCCATAAGGCCG	['CATAA', 'ATACT', 'CTATA', 'ATACTA', 'CCATAA', 'TAAGG', 'AAATA', 'TATAT', 'ATAA', 'TATA', 'CATAAG']
CGTGATCGATAAGAAAATATCACACTGTGAAGCATGATGACCACATGGCTGAAAAGAGAGAGAACTTATTTTGCTCAATCA	['ACTTA', 'TCACA', 'ATCACA', 'AACTTA', 'ATAAGA', 'ATTTT', 'AAATA', 'ATAA', 'AAAATA', 'TATTTT', 'TTATTT', 'AAATAT', 'TTTT', 'GAGAGA']
TTTGTTTCTTCTCCTTGATATAATCCTAAAAAAATCTCATAAAATTAATATATGAGATAATCTTTATTCAGCAGAAGATTA	['TCATA', 'CATAA', 'TCATAA', 'CCTAAA', 'CATAAA', 'ATAATC', 'CTCATA', 'GATAAT', 'GATATA', 'ATATA', 'TAATA', 'ATAAT', 'AATTA', 'TTAAT', 'TATAA', 'TATAT', 'ATAA', 'TAAT', 'TATA', 'AATATA', 'TATAAT', 'TAATAT', 'ATATAA', 'AAAATT', 'ATTAAT', 'TAAAAA', 'TAAAAT', 'ATAAAA', 'AATTAA', 'ATATAT', 'TTAATA', 'TTGTTT', 'TTTGTT']
AATCTGGTCAAACGTCATTATCTACGCACAGTGAGCGGTTTTGGTAATCGGGTCACCAAATATGAGCAACGTTTTTGTAAT	['CAAATA', 'TGTAA', 'TGTAAT', 'TTGTAA', 'AAATA', 'TAAT', 'AAATAT', 'TTTTT', 'TTTT', 'GTTTTT', 'TTTTGT', 'TTTTTG']
CGCGCGGCATTTTTTCCGTCTATAAGCCTGACCAGCGGAATATCGACCGCCAGTAGCGATCTATCGTCATTATTTAACGCC	['CTATA', 'CTATAA', 'TATAAG', 'ATTTA', 'ATTTT', 'TATAA', 'ATAA', 'TATA', 'TATTTA', 'ATTTAA', 'TTATTT', 'ATTTTT', 'TTTTT', 'TTTT', 'TTTTTT', 'TTTTTC']
TTAGCTATAATCTGGTACAGGGCCATAAAATCGCCACAGTAATCTCATACTCGCTTACTGTGGCGATCCCTCTTCTTCCGT	['TCATA', 'CATAA', 'ATACT', 'CTATA', 'CTATAA', 'CATAAA', 'ATACTC', 'ATAATC', 'CTCATA', 'CCATAA', 'AGTAAT', 'ATAAT', 'TATAA', 'ATAA', 'TAAT', 'TATA', 'TATAAT', 'TAAAAT', 'ATAAAA', 'GCTATA', 'TAGCTA', 'TTAGCT']
CCACTGGGGGATGACGTGATATTTATTCCGGGTCACGGACCATTATCCACACTTGGTTATGAACGCCTGCATAATCCCTTC	['CATAA', 'CATAAT', 'ACACTT', 'ATAATC', 'ATTTA', 'ATAAT', 'ATAA', 'TAAT', 'ATATTT', 'TATTTA', 'TCCCTT']
TTTTTCCACAGAAAGGAATTGTCGTTGTTACAACAATAATGAACGGATACTGACACAACATCGCTACACTTTTTAAAGCAC	['ACAAT', 'ATACT', 'ACAATA', 'ACACTT', 'AACAAT', 'ACTTTT', 'CAATAA', 'TACACT', 'TTGTTA', 'AATTGT', 'ATAATG', 'AATAA', 'TTTTA', 'ATAAT', 'ATAA', 'TAAT', 'TTTAAA', 'TTTTAA', 'AATAAT', 'TTTTTA', 'ATACTG', 'TTTTT', 'TTTT', 'CTTTT', 'TTTTTC', 'CTTTTT', 'ACACAA']
TGCTGCTGGGTAATATTCTCGGGACAGGTATTGCGGCGTGGGCATTTGAATATATGCCTATCTTCAATGAAGAAACTCGCG	['TATCTT', 'ATATA', 'TAATA', 'TATAT', 'TAAT', 'TATA', 'AATATA', 'TAATAT', 'AATATT', 'ATATAT']
TGGAGTTGTCATAAAAGCGGGGGAAGTCATTGCCCGTATTCATATGTATAAAATTGCAACATTAGGAAGCGGAAATCCGCG	['TCATA', 'CATAA', 'TCATAA', 'ATTCAT', 'CATAAA', 'TTCATA', 'GTATA', 'TAGGAA', 'TTAGGA', 'GTATAA', 'TGTATA', 'ATGTAT', 'TATAA', 'ATAA', 'TATA', 'TATAAA', 'AAAATT', 'TAAAAT', 'ATAAAA', 'TTGTCA']
CATCGGGTATGGCTGTCCTGGTACGAACAGTATTTTGTATGGGGAATGACCGCAGGCATAATTCGTGAGCTGGCGCTGCAA	['CATAA', 'CATAAT', 'TAATTC', 'TAATT', 'ATTTT', 'ATAAT', 'ATAA', 'TAAT', 'TATTTT', 'ATAATT', 'TTTT', 'TTTTGT']
AAAAAATCAGCAGGTGTTTTATATCGGCACCAACCAGCCGGAAGTGCTGACCGAAATCCGCCGTCATATTCTGGCTAACTT	['TCATA', 'TTTTA', 'TTATA', 'TATAT', 'TATA', 'TTTATA', 'TTATAT', 'TTTTAT', 'TTTT', 'TGTTTT']
GGAAGAAAATGCCCGTCTGCAATTACGCAAAGCCAGCGGCAATATCGTCACCTTCTATACTGGACTGGCGTTGTTTAATTC	['ATACT', 'CTATA', 'TATAC', 'TATACT', 'CAATTA', 'TAATTC', 'TAATT', 'AATTA', 'TTAAT', 'TAAT', 'TATA', 'TTTAAT', 'TTAATT', 'ATACTG', 'TTGTTT']
TTTACAACTGACAGCATTGCCCGCTGGCCGCTCTTTTTGCCGGTACTGCTTTTATGTTCAGCCTTTATCGGCGGTTGCGCC	['TTTACA', 'CTTTTA', 'TTTTA', 'TTTTAT', 'TTTTT', 'TTTT', 'CTTTT', 'CTCTTT', 'TCTTTT', 'CTTTTT', 'TTTTTG']
ATTTCATGCCATTAAAAATATTACCTGTGCTGAAGGTGGCCTGATTGTAACTGATAATGAAAACCTTGCCCGCCAGCTACG	['ATTTCA', 'TTTCAT', 'TGTAA', 'GATAAT', 'ATAATG', 'TTGTAA', 'ATAAT', 'AAATA', 'ATAA', 'TAAT', 'TTAAAA', 'ATATTA', 'AAAATA', 'AATATT', 'TAAAAA', 'AAATAT']
CACCTGCCTGGCAAATGAAAGCGGCTTCGCTAATGCACATCATGCTTTATATAACCTTCCTTGCACTTCCTCTGCTGGGGA	['AAATGA', 'ATATA', 'TTATA', 'TATAA', 'TATAT', 'ATAA', 'TAAT', 'TATA', 'ATATAA', 'TTTATA', 'TTATAT', 'TATATA']
CAAGGAAAAACATTAACCGTAAAAGGTAATTATGTCGGTAATAATGGTCAGCTTAATATCCGCACCGTATTAGGTGATGAT	['CTTAAT', 'GTAATT', 'ATAATG', 'AATAA', 'TAATA', 'TAATT', 'ATAAT', 'AATTA', 'TTAAT', 'ATAA', 'TAAT', 'TAATAT', 'AATTAT', 'TAATAA', 'TAATTA', 'AATAAT', 'TTAATA']
CCATTGCCGCTCACAGTTTCAGCGCGCAAATCGCCCCCTTAACAACGGAAGCTAAAATTGTCCAGGATGCGGATCGGCTGG	['TAACA', 'TCACA', 'TTAACA', 'TAACAA', 'AATTGT', 'AAAATT', 'TAAAAT', 'TTTCAG', 'CCCCC', 'CCCCTT']
GTCGATGCGGCTAACCTAATCAAACCGTTGCTCTCCAGCGGTAAAATTCGTGTAATTGGTTCGACAACCTATCAGGAGTTC	['TAATCA', 'ACCTAA', 'CCTAAT', 'TGTAA', 'GTAATT', 'TGTAAT', 'TAATTG', 'TAATT', 'TAAT', 'AAAATT', 'TAAAAT']
CTGGCGGGCGTAATAGCGAAATGACCTTAACCAGCAACTGGCCGCATCCCAGTTTTTTAGGTGATTTTCTACCAGCCAAAC	['AATAG', 'TTTAG', 'ATAG', 'AAATGA', 'TTTAGG', 'TAATAG', 'TTTTAG', 'TAATA', 'ATTTT', 'TTTTA', 'TAAT', 'TTTTTA', 'AATAGC', 'TTTTT', 'TTTT', 'TTTTTT', 'TTTTCT', 'GTTTTT']
AGGGGTTTTCCGCAGGCAGGAGAGCAAAATGCCACGCTCTGTTCGTTGATAAAAGGCCGCATAGCGGCCTTTTTCCTTTCT	['ATAG', 'ATAA', 'ATAAAA', 'CATAG', 'GCATAG', 'CATAGC', 'TTTTT', 'TTTT', 'CTTTT', 'CCTTTT', 'TTTTTC', 'CTTTTT']
ATTGCCGCCGAGGATACTCGTCACACCGGTTTATTGCTGCAACATTTTGGGATTAATGCCCGGTTGTTTGCGCTGCACGAC	['TCACA', 'ATACT', 'ATACTC', 'ACATTT', 'ATTTT', 'TTAAT', 'TAAT', 'ATTAAT', 'TTTT', 'TTGTTT']
AAGGCGGCAGTGAGAAGACCGCCATTTCAGGTTACCCTACCTTCCTGCCGGATGTGCTTCGTCCTACAAAAACTTATAAAT	['ACTTA', 'ATTTCA', 'CTTATA', 'AACTTA', 'TAAAT', 'TTATA', 'TATAA', 'ATAA', 'TATA', 'TATAAA', 'ATAAAT', 'TTATAA', 'TTTCAG']
ATTCAGACGCAGTTGAAATCGATGCTGAGTAATACCGTCAGTTCTTCCAGCTATAAAACGTTGGCGCAGATTGGTATCACG	['CTATA', 'CTATAA', 'GAGTAA', 'AGTAAT', 'TAATA', 'TATAA', 'ATAA', 'TAAT', 'TATA', 'TATAAA', 'ATAAAA', 'GCTATA']
TGCTGTATCAGGCCGTTGTTTTAGTCCGTTAGCTTCGCCACGTTCCAAGAGAAGAAACCGTCACTCATAAGCATGAACTAT	['TCATA', 'CATAA', 'ACTCAT', 'TCATAA', 'CTCATA', 'TTAGT', 'TTTAG', 'TAGT', 'TTTAGT', 'TTTTAG', 'TTTTA', 'ATAA', 'CATAAG', 'TAGTCC', 'TTAGCT', 'TTTT', 'TTGTTT', 'TGTTTT']
CATCACCTGAAGGTAAGTGCAAAGATAATCGATTCTTTTTCGATTGTCTGGCTGTATGCGTCAACGTGAAACCGGCACCGG	['ATAATC', 'GATAAT', 'ATAAT', 'ATAA', 'TAAT', 'TTTTT', 'TTTT', 'CTTTT', 'TCTTTT', 'TTTTTC', 'CTTTTT']
GAGAGTACCCAGTAGATCAATTGATTAATCATGTTTACCTTCCTGTTCGCCAGCGTCTCGTGCTTGATCACAACACCTCCC	['TCACA', 'AATCAT', 'TCACAA', 'TAATCA', 'ATCACA', 'TCAATT', 'TAGAT', 'TTAAT', 'TAAT', 'ATTAAT']
GCGCTGATGACAATTAACCAGGCGTTTTTCCAGGTGGTGTCGATGGCGACAACCGCCGGGTTTACAACTGACAGCATTGCC	['ACAAT', 'ACAATT', 'TTTACA', 'CAATTA', 'AATTA', 'AATTAA', 'TTTTT', 'TTTT', 'TTTTTC', 'GTTTTT']
TACCCGGCAAACCGATTTCTTCAACTTATACTTTAAAAGCGATTGAAACCGGTGAAGTGGTCTACGCTGATGGCAACGAAG	['ACTTA', 'ATACT', 'TATAC', 'TATACT', 'ATACTT', 'TTATAC', 'CTTATA', 'AACTTA', 'TTATA', 'TATA', 'TTAAAA', 'TTTAAA']
GCTATTTCTGACGTTAGTCATATTTCCTGCGTCGGTAATGATTTCGGTTTCAATGATATTTTCTCCCGCTACGTTGAAGCG	['TCATA', 'TTAGT', 'TAGT', 'ATGATA', 'ATTTT', 'TAAT', 'ATATTT', 'TATTTT', 'TTTT', 'TTTTCT']
TGAGCATCTACATTATAAAGCGGGCAATGCGCGAGTGATTGTGGAATGGCGCGGCTGGCGTATTTTGCCGCTGGTGTGCTA	['ATTTT', 'TTATA', 'TATAA', 'ATAA', 'TATA', 'TATAAA', 'TATTTT', 'ATTATA', 'TTATAA', 'TTTT']
TCAGGCCTACATTTTCTCCGCAATATATTGAATTTGCGCGGTTTGTAGGCCGGATAAGGCGTTCACGCCGCATCCGGCATA	['ACATTT', 'TAAGG', 'ATATA', 'ATTTT', 'AATTT', 'TATAT', 'ATAA', 'TATA', 'AATATA', 'TATATT', 'ATATAT', 'TTTT', 'TTTTCT']
GCAGACAAACCGTTGACCATCAACCTGTTGTATAACACCTCCGATCTGCATAAAAAGCTGGCGATTGCTGCCTCTTCATTG	['CATAA', 'TAACA', 'ATAACA', 'CATAAA', 'TTCATT', 'GTATA', 'GTATAA', 'TGTATA', 'TATAA', 'ATAA', 'TATA', 'TAAAAA', 'ATAAAA']
TTCGATACTAGCGCCTATGCAACGAAATTTGCTGGCTTAGTAAAGGATTTTAACTGTGAGGACATTATCTCGCGCAAAGAA	['ATACT', 'TTAACT', 'ATACTA', 'TAGTA', 'TTAGT', 'TAGT', 'TAGTAA', 'TGTGAG', 'TTAGTA', 'ATTTT', 'AATTT', 'TTTTA', 'AAATTT', 'ATTTTA', 'TTTTAA', 'ACTAG', 'CTTAGT', 'ACTAGC', 'TACTAG', 'TTTT']
TTCGTTGAACAGTGTCCGGAAGACCCGATCAGCGAAATGATCCGTGCGCAAATAAATAACATCGCGCATAAACATATTGTG	['CATAA', 'TAACA', 'ACATA', 'ACATAT', 'ATAACA', 'CATAAA', 'CAAATA', 'AACATA', 'AATAAC', 'TAACAT', 'AAATGA', 'AATAA', 'TAAAT', 'AAATA', 'ATAA', 'TAAATA', 'ATAAAT', 'AAATAA', 'AATAAA']
ATGAACTGAATGTGTTTTCTTTTTTCCATCTGTCACAACTTGTTGCGCCAGAAATGGAAAAAAATGGCGGTGGCGTTATTC	['TCACA', 'TCACAA', 'TTTTT', 'TTTT', 'TTTTTT', 'CTTGT', 'CTTGTT', 'CTTTT', 'TCTTTT', 'TTTTTC', 'CTTTTT', 'TTTTCT', 'TGTTTT']
CACACGCTACGGACCCTACGTAAAACTGTCCTGGGACGCGACAAAAGATCTTAATTTTGGCATTCGCTATCGTTACGACTG	['ATCTTA', 'CTTAAT', 'TCTTAA', 'TAATT', 'ATTTT', 'AATTT', 'TTAAT', 'TAAT', 'AATTTT', 'TAATTT', 'TTAATT', 'TTTT']
CGATAATGACTGCGTGATGCTGGCGCTGGCGGAGAAATGGCAAAATAATTCGCAGGAACGGGATTTCTGCGTGATCAACGT	['TAATTC', 'GATAAT', 'ATAATG', 'AATAA', 'TAATT', 'ATAAT', 'AAATA', 'ATAA', 'TAAT', 'AAAATA', 'ATAATT', 'AAATAA', 'AATAAT']
CCGACGCCATTCTATACCTGATAATTCTTCCCGCGGCGTTCACGTTTAAAATCAGGAATGCTGCTCGCAAAATAAAAACGC	['CTATA', 'TATAC', 'TAATTC', 'ATTCTA', 'GATAAT', 'AATAA', 'TAATT', 'ATAAT', 'AAATA', 'ATAA', 'TAAT', 'TATA', 'TTAAAA', 'AAAATA', 'TAAAAA', 'TAAAAT', 'ATAATT', 'ATAAAA', 'TTTAAA', 'AAATAA', 'AATAAA']
GCCCGACAAACTCACCTTACCGCTGCTCTGGCTTGGCTTGGTATTTAATGCGCAGTATGGATTAATTGATTTACATGATGC	['TTTACA', 'TTACAT', 'TAATTG', 'TAATT', 'ATTTA', 'TTAAT', 'TAAT', 'TATTTA', 'ATTAAT', 'ATTTAA', 'TTTAAT', 'TTAATT']
CTACCGCGCTTTACCTTGTTTAAGAAGAAACAGTTCCTGCCACTGATACAGCTATTGCGCCTTGGCGTATTACTCAACAAT	['ACAAT', 'ATACA', 'AACAAT', 'TTTAAG', 'TTAAGA', 'ATACAG', 'GATACA', 'CTTGT', 'CCTTGT', 'CTTGTT', 'TTGTTT']
ACAACGGGCGTTCATCCACTGGCGCATTCAACTGGCGAAAAGTCTGACCGAGTATAATCGGGTCTATCAATCTGCATTCTC	['ATAATC', 'GTATA', 'GTATAA', 'AGTATA', 'ATAAT', 'TATAA', 'ATAA', 'TAAT', 'TATA', 'TATAAT', 'CGAGTA']
CCATGTTTATTTCATACATTGTGGGTATTGTTCTTATTATCGCCGCTAATCAATAAAATCCTGCCCCATATCTACATGGGG	['TCATA', 'ATACA', 'ATTTCA', 'TAATCA', 'TTTCAT', 'CAATAA', 'ATACAT', 'TTCTTA', 'TTCATA', 'AATAA', 'ATAA', 'TAAT', 'TATTAT', 'TAAAAT', 'TTATTT', 'TTATTA', 'ATAAAA', 'AATAAA']
GAACAGTTGCGCGGTGGCGGCGCAGGTTTATATCGGCAGCGAATATGAACATCAGTCGATCAAAAATATTATTCAGCTGGT	['TTATA', 'AAATA', 'TATAT', 'TATA', 'TTTATA', 'ATATTA', 'AAAATA', 'TTATAT', 'AATATT', 'TATTAT', 'AAATAT']
GCGTGGCGACTCACTGGACGCCTGTGCGGAACTGGGGCGTAAGCTGAATAATCAAGGCCACTCAATAGGTATCGCTCTCGG	['TAATCA', 'ATAATC', 'AATAG', 'ATAGG', 'ATAG', 'ATAGGT', 'GAATAA', 'AATAGG', 'AATAA', 'ATAAT', 'ATAA', 'TAAT', 'AATAAT', 'CAATAG']
AAGTTACGCATTGCTGGAGCTGGGCGTGAATAATCTGGCGTTATTAGGTAAGGAGTTAATTACCCGGCCTTATTTAACGTT	['ATAATC', 'TAAGG', 'GAATAA', 'TAAGGA', 'AATAA', 'TAATT', 'ATTTA', 'ATAAT', 'AATTA', 'TTAAT', 'ATAA', 'TAAT', 'TATTTA', 'ATTTAA', 'TTATTT', 'TTATTA', 'TAATTA', 'AATAAT', 'TTAATT']
CAGAAAGCGTGGCCGATGACGCTGCGTATTCAGCCGGGATATGATCACAGTTACTACTTCATCGCCTCTTTTATAGAGGAT	['TCACA', 'CTTTTA', 'ATCACA', 'ATAGA', 'TATAG', 'ATAG', 'TTATAG', 'ATAGAG', 'TATGAT', 'TATAGA', 'TTTTA', 'TTATA', 'TATA', 'TTTATA', 'TTTTAT', 'TTTT', 'CTTTT', 'CTCTTT', 'TCTTTT']
CCTGCCGTTTCCAATGCCATCCTGGTTCACAATAAAAAAGGTGGCCCGCTGGCAGACGGTATCGTGATTACACCGTCCCAT	['ACAAT', 'TCACA', 'ACAATA', 'TCACAA', 'TTCACA', 'CAATAA', 'AATAA', 'ATAA', 'TAAAAA', 'ATAAAA', 'AATAAA']
GTTTGAAGTGCGCCACGTCCCTTACAAAATGCGTTTTGCGCTGAATAATCCACAGATTCACATCGCGGGATTACACCGCGC	['TCACA', 'TCACAT', 'TTCACA', 'ATAATC', 'GAATAA', 'AATAA', 'ATAAT', 'ATAA', 'TAAT', 'AATAAT', 'TTTT', 'TCCCTT']
ACTTGCACAAAAGCGTCATAAGGATATGAATAAATTGAAATATCTTATGACGCTTCTTATCAATAATACTTTACCGCTTCC	['TCATA', 'CATAA', 'ATACT', 'TCATAA', 'ATACTT', 'ATCTTA', 'TATCTT', 'CAATAA', 'TTCTTA', 'TAAGG', 'GAATAA', 'TAAGGA', 'AATAA', 'TAATA', 'TAAAT', 'ATAAT', 'AAATA', 'ATAA', 'TAAT', 'ATAAAT', 'TAAATT', 'ATAATA', 'AAATAT', 'AATAAA', 'AATAAT', 'CATAAG']
GCCTAAAAAATCATTCAGATTCAATAAATTGCAACGTCATGTAGGCCGGATAGGGCGTTTACGCCGCATCCGGCATCTGCG	['AATCAT', 'CCTAAA', 'CAATAA', 'ATAGG', 'ATAG', 'AATAA', 'TAAAT', 'ATAA', 'ATAAAT', 'TAAATT', 'TAAAAA', 'AATAAA']
TGGGGTGCCTTTATCCTTATCATTGCCTGGTTTTCAATGCTTCATTCCGGGTTATTGTTATTAGAAGCAAATTTAAATTAT	['TATCAT', 'TTTTCA', 'TTCATT', 'TTAGA', 'TGTTAT', 'ATTAGA', 'TTGTTA', 'TAAAT', 'ATTTA', 'AATTT', 'AATTA', 'TTAAAT', 'AATTAT', 'AAATTT', 'AATTTA', 'ATTTAA', 'TAAATT', 'TTATTA', 'TTTAAA', 'TTTT']
TGCGTTAAGACTTTTTTCATGGGTGCCGGATACAAAAAAGGCCGCAGGCTGTTACCCCTGCGGCCGGTTTCGGGCGCATAT	['ATACA', 'TTTCAT', 'ACTTTT', 'ATACAA', 'TTTTCA', 'TTAAGA', 'GATACA', 'TTTTT', 'TTTT', 'TTTTTT', 'CTTTT', 'TTTTTC', 'CTTTTT']
TATGGAGTTCATCGGTAATAATCCTAACGCCTTCCGGTTATTATTGCGGGAACGCTCCGGCACCTCCGCTGCGTTTCGTGC	['ATAATC', 'AATAA', 'TAATA', 'ATAAT', 'ATAA', 'TAAT', 'TATTAT', 'TAATAA', 'TTATTA', 'AATAAT']
TACGAATTAAGTTCAGCCAGGTGGATGTGGACTATAACGACAACACGGTAGTTATCGTCCTGAATCTCGGACAGCGGGTGG	['CTATA', 'CTATAA', 'TAGTT', 'TAGT', 'TAGTTA', 'AATTA', 'TATAA', 'ATAA', 'TATA', 'AATTAA']
ATTAAAGATGTCGATTTAACACAATATGCGGATAAGTTAATTGCACGTTTTGCTAATCCGGCGCTGAAACATAAGACCTGG	['CATAA', 'TAACA', 'ACAAT', 'ACATA', 'ACATAA', 'ACAATA', 'TTAACA', 'AACATA', 'TAATTG', 'ATAAGT', 'ATAAGA', 'TAATT', 'ATTTA', 'TTAAT', 'ATAA', 'TAAT', 'ATTTAA', 'TTAATT', 'CATAAG', 'TTTT', 'ACACAA']
GGTAATACATACTATAAAGATACACAGCGCCGTAACAAAGAACTCGCTGAAAGCGGCATTCATTTTATCGGAACAGGCGTT	['TAACA', 'ATACA', 'ATACT', 'CTATA', 'ACATA', 'CTATAA', 'ATTCAT', 'ACATAC', 'TCATTT', 'TACATA', 'ATACTA', 'ATACAT', 'AATACA', 'TAACAA', 'TTCATT', 'TAATA', 'ATTTT', 'TTTTA', 'TATAA', 'ATAA', 'TAAT', 'TATA', 'TATAAA', 'TTTTAT', 'ATTTTA', 'GATACA', 'TTTT']
ATTGATGATATGGTCAACGGTATTCTCTGGCTGCTGGATAACGAGCTGCGCGGGCCATTTAATATGGTTTCGCCCTACCCG	['ATGATA', 'TAATA', 'ATTTA', 'TTAAT', 'ATAA', 'TAAT', 'TAATAT', 'ATTTAA', 'TTTAAT', 'TTAATA', 'GCCCTA']
GGCACCAATCCGTTCTGTGTGGTTTTCCCTCGTAAAGATAATTTCCCGCTGTTGCTTGATTACGCCACCAGCGCCATTGCA	['AATTTC', 'GATAAT', 'TAATT', 'AATTT', 'ATAAT', 'ATAA', 'TAAT', 'ATAATT', 'TAATTT', 'TTTT', 'TTGCTT']
CGAGAGTATCGGATATTTTAATAACTATTTGGTTGAGCTGGTGGCTGGTTCTTTTTCCCTGCTATCGGCTTTCAACTTCAC	['AATAAC', 'AATAA', 'TAATA', 'ATTTT', 'TTTTA', 'TTAAT', 'ATAA', 'TAAT', 'ATATTT', 'TATTTT', 'ATTTTA', 'TAATAA', 'TTTAAT', 'TTTTAA', 'TTAATA', 'TTTTT', 'TTTT', 'CTTTT', 'TCTTTT', 'TTTTTC', 'CTTTTT']
AGCTTGTTCAGCGGTGATCAACTGATGAGCCAGCTCCGCGCACAGAACCATTTATATACCGTGCTGGAGAAAGGTGCGGAC	['TATAC', 'ATATAC', 'ATATA', 'ATTTA', 'TTATA', 'TATAT', 'TATA', 'TTTATA', 'TTATAT', 'TATATA', 'CTTGT', 'CTTGTT']
GCGCAGTGCCCAGCCATCCCGATACTGCTGCTTTCACCAAATCCTTAGTGCTTCTTTCGTGTTTTTCTATTGTCATAATGG	['TCATA', 'CATAA', 'ATACT', 'TCATAA', 'CATAAT', 'TTAGT', 'TAGT', 'ATAATG', 'ATAAT', 'ATAA', 'TAAT', 'CTTAGT', 'ATACTG', 'TTGTCA', 'TTTTT', 'TTTT', 'TTTTTC', 'TTTTCT', 'GTTTTT', 'TGTTTT']
GATTATGCTTATACCTGGCGACGAGGCAAAGGTAACCTGGAAATTCGTAATGTTGTGTTATATTTTTCCAGAGGTTCTTTA	['TATAC', 'TTATAC', 'CTTATA', 'TAATGT', 'TGTTAT', 'GTTATA', 'ATTTT', 'TTATA', 'TATAT', 'TAAT', 'TATA', 'ATATTT', 'TTATAT', 'TATTTT', 'TATATT', 'ATTTTT', 'TTTTT', 'TTTT', 'TTTTTC']
AGAACTTTTGTACACGTTTAAGCTATTATTATTAAAAAGTGTTTGCAAAATGGTCAAGATTATAATATTGCTGAATTATAT	['CTATTA', 'ACTTTT', 'TTTAAG', 'TAATA', 'ATAAT', 'TTATA', 'AATTA', 'TATAA', 'TATAT', 'ATAA', 'TAAT', 'TATA', 'TATAAT', 'TAATAT', 'TTAAAA', 'TTATAT', 'AATTAT', 'AATATT', 'TATTAA', 'TATTAT', 'ATTATA', 'TAAAAA', 'ATAATA', 'TTATTA', 'TTATAA', 'GTCAAG', 'TTTT', 'CTTTT', 'TTTTGT']
GCAATGAACAACATTCTGGCGCAGATGAACGGTAAGCCGCTGAAAAATTATCAGTATAAAGATCATGGTTCGCTGGTATCG	['GTATA', 'GTATAA', 'AGTATA', 'AATTA', 'TATAA', 'ATAA', 'TATA', 'TATAAA', 'AAAATT', 'AATTAT']
TGGATCCTGCGCAAAATCATTCACCCGATGGGCGAAATCGATGCAATGGAATTCCTCATTAATAAACTGGCAATGACCAAG	['AATCAT', 'CCTCAT', 'AATAA', 'TAATA', 'TTAAT', 'ATAA', 'TAAT', 'ATTAAT', 'TAATAA', 'AATAAA', 'TTAATA']
GAGACTCTTAATTCGCGTCGGGTCACTACGCCTTAATGAAAATCATGCCATCAAAGGAACGTTGCAGGAGTTGATAAATAC	['AATCAT', 'CTTAAT', 'TCTTAA', 'ACTCTT', 'TAATTC', 'TAATT', 'TAAAT', 'TTAAT', 'AAATA', 'ATAA', 'TAAT', 'TAAATA', 'ATAAAT', 'TTAATT']
CTGAAGGTTTTACAGGCAGCGGATTTTGTCTATCAGGACAGTCAATTAGGCTGGTGGCATATAGGATTAGGTGTCTTTAAC	['TTTACA', 'CATATA', 'CAATTA', 'TCAATT', 'ATAGG', 'TATAG', 'ATAG', 'ATAGGA', 'TAGGAT', 'AATTAG', 'TATAGG', 'ATATAG', 'ATATA', 'ATTTT', 'TTTTA', 'AATTA', 'TATA', 'TTTT', 'TTTTGT']
TCTGATAGTTAACATTACAAGATATAAGTAATGGACGCACTCCCAATTAGTCTATTTAAATCGCCACGAGTTTAACTGACA	['TAACA', 'TAAATC', 'CAATTA', 'TTAACT', 'TTAACA', 'TAACAT', 'TTAGT', 'ATAGT', 'TAGTT', 'TAGT', 'ATAG', 'TATAAG', 'GATAGT', 'ATAGTT', 'GATATA', 'TAAGTA', 'AATTAG', 'AAGTAA', 'AGTAAT', 'ATAAGT', 'TAGTTA', 'ATATA', 'TAAAT', 'ATTTA', 'AATTA', 'TATAA', 'ATAA', 'TAAT', 'TATA', 'ATATAA', 'TTAAAT', 'TATTTA', 'ATTTAA', 'TTTAAA']
GTTAAATATTGAAACGGGCGTATAACACGCCCGTTGTTTTATTTATGTGGATATTATTAATAGCATATCGAGCATATTTAT	['TAACA', 'ATAACA', 'AATAG', 'GTATA', 'ATAG', 'GTATAA', 'TAATAG', 'TAATA', 'TAAAT', 'ATTTA', 'TTTTA', 'TTAAT', 'AAATA', 'TATAA', 'ATAA', 'TAAT', 'TATA', 'TTAAAT', 'TAAATA', 'ATATTA', 'ATATTT', 'AATATT', 'TATTTA', 'ATTAAT', 'TATTAA', 'TATTAT', 'TTTTAT', 'TTATTT', 'TTATTA', 'AAATAT', 'TTAATA', 'ATAGCA', 'TAGCAT', 'AATAGC', 'TTTT', 'TTGTTT', 'TGTTTT']
CAAAGGGGGCCAAAGCCCCCTAATACTCAACTAACCACCGATAGGTAAACGAATCCCGATGAGCTTACACCAGTAAGTGAT	['ACTAA', 'ATACT', 'CTAATA', 'CCCCTA', 'ATACTC', 'AACTAA', 'CCTAAT', 'ATAGG', 'ATAG', 'ATAGGT', 'TAATA', 'TAAT', 'CCCCC']
TTTTTCACGAGCCCCCAACCTGTTTGGCCTGTTTGCCAATAGGCGCGCAGCTTTGCAAGCATTGCAGACCATCGCTGATGA	['TTTTCA', 'AATAG', 'ATAGG', 'ATAG', 'AATAGG', 'ATAGGC', 'CAATAG', 'CCCCC', 'TTTTT', 'TTTT', 'TTTTTC', 'CCCCCA']
TTAAAGAAGGGATAGATCTTCAGGCGCTGGAACTGGCGTTGCAGGAGTATCCGGTGAAAGCGTGCTGGCTGATGACTAATA	['ACTAA', 'CTAATA', 'ACTAAT', 'TAGAT', 'ATAGA', 'ATAG', 'GATAGA', 'ATAGAT', 'TAATA', 'TAAT', 'GACTAA']
GATCGCGGGTTTATTTTGCATACTCCGCCCTCCAATTTTGCTTCCAGCATTCGCATTTCAGACAACACGGTAATGACCACT	['ATACT', 'ATTTCA', 'ATACTC', 'CAATTT', 'ATTTT', 'AATTT', 'TAAT', 'TATTTT', 'AATTTT', 'TTATTT', 'TTTCAG', 'TTGCAT', 'TTTT', 'TTGCTT', 'CCCTCC']
GAATCGCGGGATCGCATTATATTACGGCGGTCGTGACAAGTTAGCGCAAGATGATCTGCTGGCGTTTTATCAAGACGATCC	['TTTTA', 'TTATA', 'TATAT', 'TATA', 'ATATTA', 'TTATAT', 'TATATT', 'ATTATA', 'TTTTAT', 'TTTT']
CGCAAAGTAAAAATAGCCAAACATCTTCGTTATGGGATGCATTTGCCTATACGTTAGCCATTCTTTACTACGAAAATTTTA	['CTATA', 'TATAC', 'CCTATA', 'AATAG', 'ATAG', 'AAATAG', 'AAGTAA', 'ATTTT', 'AATTT', 'TTTTA', 'AAATA', 'TATA', 'AAAATA', 'AAAATT', 'AAATTT', 'AATTTT', 'TAAAAA', 'ATTTTA', 'AATAGC', 'TTTT']
ATCCGTAACGGCAATGAAGCGGTATTAATTGGTCAGTTAGAGTGTAAATCGATGGTCAGGATGTGTGCGCCACTGGGCAGT	['TAAATC', 'TTAGA', 'TGTAA', 'TGTAAA', 'TAATTG', 'TAGAGT', 'GTTAGA', 'TAATT', 'TAAAT', 'TTAAT', 'TAAT', 'ATTAAT', 'TATTAA', 'TTAATT']
TAATCAGGAACTCACCGAAGTTGCTGAGTTAATAACTTCACCAGAAGCAATAAAAAATAATCTGGCAGTCGCTTTTCTGAC	['TAATCA', 'CAATAA', 'ATAATC', 'AATAAC', 'AATAA', 'TAATA', 'ATAAT', 'TTAAT', 'AAATA', 'ATAA', 'TAAT', 'AAAATA', 'TAAAAA', 'TAATAA', 'ATAAAA', 'AAATAA', 'AATAAA', 'AATAAT', 'TTAATA', 'TTTT', 'CTTTT', 'CTTTTC', 'TTTTCT']
TGGAAAGCCGTGATCCGCAACTGGCGGCGATTTCTGCCAAAGCAATTAAAGAAGCGCGCTATCACCTGCGTTTTAGTCGTG	['CAATTA', 'TTAGT', 'TTTAG', 'TAGT', 'TTTAGT', 'TTTTAG', 'TTTTA', 'AATTA', 'AATTAA', 'TTTT']
CACTTGTTTATGCCGGATACGGCGTGAACGCGTTATCCGGCTAACAAAATCGTGAAAACTCAATAAATTGCAGAAACCCCA	['TAACA', 'CAATAA', 'TAACAA', 'AATAA', 'TAAAT', 'ATAA', 'ATAAAT', 'TAAATT', 'AATAAA', 'CTTGT', 'CTTGTT', 'TTGTTT']
TTAACGCCGACGGTCAATAATATTGCTGCCGATCTGATGGTACGCATTAACAACGCAGGCGCGGCAAACGCCATGAACCTG	['TAACA', 'CAATAA', 'TTAACA', 'TAACAA', 'AATAA', 'TAATA', 'ATAAT', 'ATAA', 'TAAT', 'TAATAT', 'AATATT', 'ATAATA', 'AATAAT']
ACAGGTACGTTAATCGGAACGTTGAGCGCATTTCCTTTCTTTATGGCGCTTGAAGCACAATCTATTTTCTGGATAGTTTTC	['ACAAT', 'ATAGT', 'TAGTT', 'TAGT', 'ATAG', 'TAGTTT', 'GATAGT', 'ATAGTT', 'ATTTT', 'TTAAT', 'TAAT', 'TATTTT', 'TTTT', 'TTTTCT']
TGCAACGCTATCTTTTACAGCGCCACCAGCAGGCTGGTGTGCGCATTCTGCTCAATAATGCCATTGAACATGTGGTCGATG	['TTTACA', 'TATCTT', 'CAATAA', 'CTTTTA', 'ATAATG', 'AATAA', 'TTTTA', 'ATAAT', 'ATAA', 'TAAT', 'AATAAT', 'TTTT', 'CTTTT', 'TCTTTT']
GTCATCAATAAAGAGAATTTTCAGCGCGCTCGCATGGCGGCAGCACAAAAACTGGAAACTTTAACCTGGCAATTCCGTATT	['CAATAA', 'TTTTCA', 'AGAATT', 'AATAA', 'ATTTT', 'AATTT', 'ATAA', 'AATTTT', 'AATAAA', 'TTTCAG', 'TTTT']
