AAAGGCAAAGCGACAGTAATCCTTGCTCATACCATTAAAGGTTACGGCATGGGCGACGCGGCTGAAGGTAAAAACATCGCG	['GGTAAA', 'GTAAAA', 'TAATCC', 'TACCAT']
CTACGGCATTGTTAACTACCTCGGCGTCGATCTTCTGCATCTCTATGAGCAGGCACCGCTGTGGTTCGATAATCCGGGCAG	['ATAATC', 'CGATAA', 'GATAAT', 'TAATCC']
TCCGGATTGTCACGTTCCGCACGAGTTTGTGCCGAAGATGATACGCAAGCTCAAAGCAAGTAAAGAGCTGTATGGTAAAAT	['ATGGTA', 'GGTAAA', 'GTAAAA', 'TAAAAT']
CACTATGAAACCGGCGAACCGCTGCCGAAAGAGTTGCTGGATAAAATGCTGGCGGCGAAGAACTACCAGGCGGCGCTGTTT	['AAAATG', 'ACTATG', 'GGATAA', 'TAAAAT']
CCACTTTACGTTACGCATGGGTCAGAGAATATACCAAAAATAGAAAGCGGCATTACCATTTGATACTGTGTTTCAATCAGG	['AGAATA', 'ATACTG', 'ATATAC', 'GATACT', 'TACCAT']
TCAGCAGGGTGGGGAAGCAATAGTTATCAGAACTATGATGTCTCTACGCAGCAACAACTGGGGGATAAGACACGGGTAACG	['ACTATG', 'ATAGTT', 'GGATAA', 'TATGAT']
GAAGCAGCGCCCATACCCGACGATAACCATACGTTGGCAGCTCTCCGATAACATGGTGTATACGGAGAAGCACATCCGTAT	['CGATAA', 'GTATAC', 'TAACAT', 'TGTATA']
GTGGATCAGACCAGTTTAAAAGAGCGGCATATCACTGGGCTGCATTACAACCCGATCACTAATACTTTTAAACTCGGCCCC	['ATACTT', 'TAAACT', 'TTAAAA', 'TTAAAC']
GCCGCTAATGCTGGTAGCCTGAAAACCGATCCATGGACACTGAAAATCAGCGGCGAAGTGGCAAAACCATTGACCCTCGAT	['ACACTG', 'CGCTAA', 'GACACT', 'TAATGC', 'TAGCCT']
TAGTTTTGCCGAAGTGGAGTCTAAACTGGGGTTACCACTGTTTGTAAAACCGGCTAATCAGGGCTCTTCTGTTGGTGTCAG	['CTAAAC', 'GGCTAA', 'GTAAAA', 'TAAACT', 'TCTAAA']
ATGAACTACATAATACATCACAATTTATTATAGATAATATCCTTCAAACGGTACATAAACCAGAACGATCTGTAAGATTAG	['ACAATT', 'AGATAA', 'CACAAT', 'CATAAT', 'GATAAT', 'TATCCT', 'TATTAT']
TAATAGTCTTTTTAATATGTGACAATAGTGTTGCTAAGGTGTGATTGAAGCGTGGAGTTTACGCACGTTGAGTGATCACCT	['ACAATA', 'ATAGTG', 'GACAAT', 'GCTAAG', 'TAAGGT', 'TAGTCT']
TAGCCCATGAATAACAATCAGAAAGGACCATAACAGACCCGTTAAAATGAAATATAAGAGACGGTCAACGGGTGAAGAAAA	['AAAATG', 'ACAATC', 'CGTTAA', 'GTTAAA', 'TAAAAT', 'TTAAAA']
AAGAAAAACATTGAATTCTTCGAAGCTCGTCGCGCTGAACTGGAAGCTAAACTGGCTGAAGTTCTGGCAGCTGCTAATGCT	['AAGCTA', 'CTAAAC', 'GCTAAA', 'TAAACT', 'TAATGC']
GATAACCTGCGCAATGTAGCGGCGGCGCTCGGCAAACCGTTGAGCGAACTGACGGTAACGATTCTGGCTAAACCACGCCAC	['CTAAAC', 'GCTAAA', 'GGCTAA', 'TAACCT']
CGTGAGGTGCGCAGAAAAAAGATTGCGATGGTCTTCCAGTCCTTTGCCTTAATGCCGCATATGACCGTGCTGGACAATACT	['ACAATA', 'ATATGA', 'GACAAT', 'TAATGC']
GATCACCCAAACCAGTATCTGGTTAAACCGGCGACCACTATTGCCGACAATATGATGCCAGTAATGCAGCATCCGGCGCAG	['ACAATA', 'ATATGA', 'GACAAT', 'GTTAAA', 'TAATGC', 'TATGAT', 'TTAAAC']
GAATTTGAAGAGTGTCTTAAAATCCTCGACGCGGTAGATTTTCCGCCAGAGCGCATTTTGAATGTTTCTCCGCGCCGCTTA	['CTTAAA', 'TAAAAT', 'TAGATT', 'TTAAAA']
AGCGCCGTTTAATGATTGCCCGTGCGTTAATGCATGAACCTAAACTACTGATTCTCGACGAACCGACCGCAGGCGTGGATA	['CGTTAA', 'CTAAAC', 'TAAACT', 'TAATGC']
AAACCTGGCCCGCATAAAATTCAGGGTATTGGCGCTGGTTTTATCCCGGCTAACCTCGATCTCAAGCTGGTCGATAAAGTC	['AAAATT', 'CGATAA', 'GGCTAA', 'TAAAAT', 'TAACCT']
GTTAGAGTCATTACCGTTTCGTCTATATAAAAACTTATGTTTTTGGTACATTAGCAGTATATATCATCTCTATCATCACAA	['AAACTT', 'AGTATA', 'GTTAGA', 'TAGAGT', 'TATCAT', 'TCTATA']
TACAGTGCATAATGTGACATTTGGAATGCTTATCAACTGCATGTAAACATTAATAACCTGCACTTTTTTGTCTTAAGGTTT	['ATAATG', 'CATAAT', 'TAACCT', 'TAAGGT']
GCAGTGCCATTTATGATAAAAACATCCCTTAAAACCAATCTAATCTTTTTCTTCCTCTGTGTATTTGTTCCCCATATGGCG	['CTTAAA', 'TAATCT', 'TATGAT', 'TTAAAA', 'TTATGA']
ACGCTTAGGCGTGTGACTGCGTACCTTTTGTATAATGGGTCAGCGACTTATATTCTGTAGCAAGGTTAACCGAATAGGGGA	['ATAATG', 'TATAAT', 'TATATT', 'TATTCT', 'TGTATA']
GCCGATAAGCTTGAAAATTGTCTGATGAGCTTAACGCTGAGTATCCAGAGCCTGCAGAAGCACGCCATGCTTGAGAAGGCC	['AAAATT', 'CGATAA', 'GAGTAT', 'GCTTAA', 'TAAGCT']
TACCACGTTTGATAAGGATAAAATCCCGACATGGTCCGTAAAAGCAGATAAAGCCAAGCTGACCAATGACCGGATGCTCTA	['AGATAA', 'GGATAA', 'GTAAAA', 'TAAAAT']
TGATGAATATCTATTGGTCAGAAAAAATTTATTGATCAGTTCTAAATCGATTAAACCGGAATCTCTCGACGATATCCTTGG	['AAAATT', 'TATCCT', 'TCTAAA', 'TTAAAC']
GACATTATGTTTGAATGGGTTACACAGAATATTATGAATGGCCGCGGCGTTAATCGTCTGGATGATGTTAATCGGCCAAAA	['AGAATA', 'ATGTTA', 'CGTTAA', 'TATTAT', 'TTATGA']
CGTGGCTTCCAGTCCAATACCATTGGTCCGAAAGCAGTTTACTTCCCGCATCAGGCCAGTAATTATGATCCGGACTATGAT	['ACTATG', 'GACTAT', 'TACCAT', 'TATGAT', 'TTATGA']
TGTACAACATTCCAGCCCTGAGTGGGGTAAAACTGACCCTGGATCAGATCAACACACTTGTTACATTGCCTGGCGTAGGTG	['ACACTT', 'CACACT', 'GGTAAA', 'GTAAAA']
TTAATTCAATACGTCGTGAATGAATGTATTGCGGCTGGCATTACTGAAATTGTGCTGGTTACACACTCATCTAAAAACTCT	['CACACT', 'CTAAAA', 'TAATTC', 'TCTAAA']
ACCTTATGATGAATCGAGCGGCTTAATTGCAGAACTGGTGGGGCATCTGGCTTCACTGCTAATGCAGCTAAACATCTGGCG	['CTAAAC', 'GCTAAA', 'GCTTAA', 'TAATGC', 'TAATTG', 'TATGAT', 'TTATGA']
TTTTGCCCACCTGGCTCGCCGCACCTTAAAATACGACAGATAAAATTATAGGCAGCCATAAAAATAGTGATCTCAAAACGT	['AAAATT', 'AGATAA', 'ATAGTG', 'CTTAAA', 'TAAAAT', 'TTAAAA']
AATGGGTCAGGACGCTTTTAATCACATATAAAAAGCGTCCTTTTTCTCACAATCAAATGATCATCGGCTTCTATAACGAAA	['ACAATC', 'CACAAT', 'CATATA', 'CTATAA', 'TCTATA']
AGCTCCGCTGTGAGCGCAGGCTGTGTTAAAACTCCTGATCACTTTTTGGTCTAAGCGATGGTTTCATATGATCAACCATTC	['ATATGA', 'CTAAGC', 'GTTAAA', 'TATGAT', 'TTAAAA']
CGCGGTTTTCCTGATTTTAAACTTCATCTGGCACAGAGTCTGGCGAATGGCACTCCCTATGTTAATCGCAATGTCAATGAA	['AAACTT', 'ATGTTA', 'TAAACT', 'TTAAAC']
CAGTATTTAGGCACTCGCTATGATAAGGATTACTCATCTTATCCTTATCAAACCGTTAAAATGGGCGGTGTGAGCTTGTGG	['AAAATG', 'CGTTAA', 'GTTAAA', 'TAAAAT', 'TATCCT', 'TATGAT', 'TTAAAA']
TGGGCGATATTTTCCGCTGGGGAGAGGCATTAATTCAGGTCAGCCAGCCGCGCTCGCCTTGCTATAAACTCAATTACCATT	['CTATAA', 'TAAACT', 'TAATTC', 'TACCAT']
CGGCAAAATGGCGCTGGTACACTTTGACGCCCACACCGATACCTATGCGAACGGTTGTGAATTTGACCACGGCACTATGTT	['AAAATG', 'ACACTT', 'ACTATG', 'TACACT']
CAAGGCTAAATACTCCTGACTGACCGATAGTGAACCAGTACCGTGAGGGAAAGGCGAAAAGAACCCCGGCGAGGGGAGTGA	['ATACTC', 'ATAGTG', 'GCTAAA', 'GGCTAA']
TCTGGTTGATGGCCTGAACTTCGCTGTTCAGTACCTGGGTAAAAACGAGCGTGACACTGCACGCCGTTCTAACGGCGACGG	['ACACTG', 'GACACT', 'GGTAAA', 'GTAAAA']
ATGCAAAATCGGTATCCAGCCTGGTCACATTCACAAACCGGGTAAAGTGGGTATCGTTTCCCGTTCCGGTACACTGACCTA	['ACACTG', 'GGTAAA', 'TACACT', 'TATCGT']
GCGTTTAACCAGGAAATGCCGCCATTGATGAGTATCGAGCGTAAAATGTTCCACATCACGCAGATTGGCGTGGTGCTGCTA	['AAAATG', 'GAGTAT', 'GTAAAA', 'TAAAAT']
CCGCTGGCGGCGGGTGCACTGGCTAAAACCGGTAAATACGACGCGGTGATTGCGCTGGGTACGGTTATTCGTGGTGGCACT	['CTAAAA', 'GCTAAA', 'GGCTAA', 'GGTAAA']
TCTATATCGCGTTATTGATGCCCGCTCAGGCGATTCACTATTTTATGTTGTCGCCCTACAGCGTGGTGATGGACGTTAAAA	['CGTTAA', 'GTTAAA', 'TCTATA', 'TTAAAA']
GATATCCTGGCGAAAGATCGCAAAAGTGAAGAGTTACCAGCTTCTAATCTGGTCTTTCTTATCGACACTTCTGGTTCAATG	['ACACTT', 'GACACT', 'TAATCT', 'TATCCT']
TGCCTGCACCACAGTCACTCCAGCTTATAAAGATAACGGCACACGCAGTGGTCCTTGCGTTGAAGGAGGCCCGGATAACGT	['AAGATA', 'AGATAA', 'GGATAA', 'TAACGT']
ACGGCAGAGATTAAGGTCGGCGATAACGATAACCTTTCTGCGCTGGCGGCGATTCTTGCGGGTGCCGATAAACTGTTGCTG	['CGATAA', 'TAAACT', 'TAACCT', 'TAAGGT']
CCCAAAAGTGCCCGGACAGTCCCCTCGCCCCTTCGGGAAAAGGGTTAGGGTGAGGGGAAAATTGTGTTCACACTGACGAGT	['AAAATT', 'ACACTG', 'CACACT', 'TAGGGT']
TGAGCAATCGACGCCGTTTTTTTATAGCTTATTCTTATTAAATTGTCTTAAACCGGACAATAAAAAATCCCGCCGCTGGCG	['ACAATA', 'CTTAAA', 'GACAAT', 'TATTCT', 'TTAAAC']
CTCGACTATGAAACGCTGATGGCGGCGCTGCTGCATGACGTGATTGAAGATACTCCCGCCACCTACCAGGATATGGAACAG	['AAGATA', 'ACTATG', 'ATACTC', 'GACTAT', 'GATACT']
ACATTACGATTGCCGCCCGGATGACGAAACACCCACCCTGCTGGTGGTGCACAATATTAGCCTGCCGCCAGGCGAGTTTGG	['ACAATA', 'CACAAT', 'TACGAT', 'TAGCCT']
GCAATGCTAAAACGCCACGGTATGGGTTTTGAAGGGATGCGCGTTTCCGTTTCTGGCTCCGGCAACGTCGCCCAGTACGCT	['ATGCTA', 'CTAAAA', 'GCTAAA', 'TACGCT']
TTGTTTCCTTACAATATTCAAAATTACGCTTACGGATTAACCACAATCGCCTTCTGGCCTTATACCCTTATTTCGGCACTC	['AAAATT', 'ACAATA', 'ACAATC', 'CACAAT', 'TACAAT', 'TACGCT']
AAAGCTAAAGCGCCTATTTATTTTGTTAGCCGCAAAGAAAGTATCAAAAATCTTCTTGAGATTACTTATGGTAAACACTTG	['AAGCTA', 'ACACTT', 'ATGGTA', 'GCTAAA', 'GGTAAA']
GCCAACAGAGGTTAAACAGGTAGTAACTATGGATATGGATCTAAACAATCGCCTGACTGAAGATGAAACGCTTGAACAGGC	['ACAATC', 'ACTATG', 'CTAAAC', 'GTTAAA', 'TCTAAA', 'TTAAAC']
AGAAACCACCCCGCGTAATCCAGTAACCAACAGTGGACGAGTATTAGAAGAACTCGAAGACTGGCTGCACAATTTACCCGG	['ACAATT', 'AGACTG', 'CACAAT', 'GAGTAT', 'TAATCC']
GGCTTCGGGCAAATCCGATCAAAACTATTCTCGACAATCAAAAGCGCCTGGACAGTAAAGGGAATATTAAACGCTGTCGGG	['ACAATC', 'GACAAT', 'TATTCT', 'TTAAAC']
ATCGCCGCGCAGAATTTCAGATAATTATCTCCCCGGAGTATCAGGGGAAAGGTCTGGCAACCCGTGCCGCCAAATTAGCAA	['AGATAA', 'ATAATT', 'GAGTAT', 'GATAAT']
TGACTGGGGGGAATCCTTGCTAGTTATATAAGGTCACTGTTAGCTAGAGGCTTGAGCGACAAAAGTGTCATTTGGATTGAG	['CTGTTA', 'GCTAGA', 'TAAGGT', 'TGCTAG']
TGGACGAAGCCTTCTCGGCGCTCGATCCATTAATTCGCACCGAGATGCAGGATGAGCTGGTAAAATTACAGGCGAAACATC	['AAAATT', 'GGTAAA', 'GTAAAA', 'TAAAAT', 'TAATTC']
CGGTCAGCCGGAGAAAATTCTCGCCCTTGAGATGGGCGGTAATAATCCGCTAATTATCGATGAGGTGGCGGATATCGACGC	['AAAATT', 'ATAATC', 'CGCTAA', 'TAATCC']
GTAACCCCAGCCATGCTGAAAGTGGTCGACGCTGCAGTCGAGAAAGCCTATAAAGGCGAGCGTAAAATCTCCTGGATGGAA	['CCTATA', 'CTATAA', 'GTAAAA', 'TAAAAT']
CGGCAGCGCGAAGATTATGCCGTTCTTTAAAACGCTGCTGGTGGAGCTCGCGCCAGTGTTCGACTCGCTCGATAATAAAAT	['CGATAA', 'GATAAT', 'TAAAAT', 'TTAAAA']
TTTGCTGCCTGCGCATTGATAATCTTGAGTTTATGAGTCGTCATTACGGCTTAATGATGCGCGTTCACTGTATCCGCTCAA	['ATAATC', 'GATAAT', 'GCTTAA', 'TAATCT', 'TTATGA']
TTGTCATAATGACCCGCCAACTGATGAAACAGACTGCGGATATTCTGATGCCGGTAAAACATTTGCTGCCGGACAATTTCC	['ACAATT', 'AGACTG', 'ATAATG', 'CATAAT', 'GACAAT', 'GGTAAA', 'GTAAAA', 'TATTCT']
GCCAGCAACAATATTTATGACTATACCAACGAAACCGCGAACGACGTTTTCGATGTGCGTTTAGCGCAGATGGAAATCAAC	['ACAATA', 'CTATAC', 'GACTAT', 'TTATGA']
GATTTTTACGTCGTTTGGTTTTCACGGTAGCGTGCCGAGTATTGTCAGCTATATGGATGGCAACATTCGTAAGCTACGCTG	['AAGCTA', 'GAGTAT', 'TAAGCT', 'TACGCT']
GTGGCTTTCGAATATTTTACTGTGCGTATTATTCAGTTATTTCGTACTGAACAGAATCAAGCGTATTATAATTGCGAGTCG	['ATAATT', 'TAATTG', 'TATAAT', 'TATTAT']
GTAGTGAGTCTATTTGTGGTCACTAGCACTGTCTCCTAAACTTGTAAGAGGTCTGAAGCTATTCTTTGATTTTTGCTAGTG	['AAACTT', 'AAGCTA', 'CTAAAC', 'TAAACT', 'TATTCT', 'TGCTAG']
GGAATCACCACTCGAAAGTGTGATGGCAGCGGCGAAAATCGCCCATCAAAATAAGACTATCGTTGCGCTTAACCCGGCTCC	['AGACTA', 'GACTAT', 'GCTTAA', 'TATCGT']
TTAACCAATCTGCTGGATAGCGATGACGTGCGCCATATGCTGAATGCATTAACAGCGTTAGGGGTAAGCTATACGCTTTCA	['AAGCTA', 'CTATAC', 'TAAGCT', 'TACGCT']
GCTGAAGTATTTCCAAAAATTAAACTCTGGCAGGGCTTACTGGCAGGTGCTTTAGCCCAACTTTTTGTTCATATGATTTCA	['AAAATT', 'ATATGA', 'TAAACT', 'TATGAT', 'TTAAAC']
GCATCAAACAGTTTGGTATCAAAACGCCTAAAACAGATGCTATGATTCTCGCAGGGATAATATTATCCGGATCGTTTTCAG	['ATGCTA', 'CTAAAA', 'GATAAT', 'GGATAA', 'TATGAT', 'TATTAT']
GTAAAATGCTTCTGCCATGGTTATTCCCACAAACGAAACGGAATAATTTTGCAGCAAAAGTGAACAGTGAGAACCAGGAAA	['AAAATG', 'ATAATT', 'GTAAAA', 'TAAAAT']
TACCACCTCGGGGATTACGATCAGGACGATAACCTTAGAGGGATGATCACAGGAGCCTGGTACAGCGCCCTGAGACTGGAG	['AGACTG', 'CGATAA', 'TAACCT', 'TACGAT']
TTTTAATGTGGCTTTCCGGCGAGTATATGACCGCAAATGGTCAATGGGGACTAAACGTCCTACAAACCGCCGACCACAAAG	['AGTATA', 'ATATGA', 'CTAAAC', 'GAGTAT']
TTAATCCAAGCACAGCGCGACTACTTTGGCGCTCATACTTATGAGCGTACTGACAAAGAAGGCATCTTCCATACTGAATGG	['ATACTG', 'ATACTT', 'CATACT', 'TAATCC', 'TTATGA']
CAACTGGGGTGATGAAAAGCTAAGCCCCGGTTACACCGTGACCACCGGCTGGAAAAACTTTACCCGCGTCTTTACCGACGA	['AAACTT', 'AAGCTA', 'CTAAGC', 'GCTAAG']
AGGCGCTCGAAAATACAATATGGGTATTAGGCTTTGTTGGCACTGCATTTGATACTAAATTTAGTGCCAACAAAGCATCGG	['ACAATA', 'GATACT', 'TACAAT', 'TAGGCT']
ACGATGAAGCATCAGGTATGCAGCAGGCTTTGATCGCTAAAGGCGTACCAGCAAAAGTGATCTTCTGCGACTATGCCGGAT	['ACTATG', 'CGCTAA', 'GACTAT', 'GCTAAA']
AAAAAATGACCAATTTGATCAGTATAAAAAACAGGTTGGTTATTCACTATTTAAGGACTATATACTATGAACAAAATTATA	['AAAATG', 'AAAATT', 'ACTATG', 'AGTATA', 'ATATAC', 'GACTAT']
GCCTATAAAATTGCTGAACTGGCAGGCTTCTCTGTACCAGAAAACACCAAGATTCTGATCGGTGAAGTGACCGTTGTTGAT	['AAAATT', 'CCTATA', 'CTATAA', 'TAAAAT']
ATTGTTGCAGGTAATAAAAATGAACTCTTACTGCTGGATCTATCCCATAATAAACTAACAAGTTTACACAATGACTTATTT	['AAAATG', 'ACAATG', 'CACAAT', 'CATAAT', 'TAAACT']
GACGGTATCCTGCACGTTTCCGCGAAAGATAAAAACAGCGGTAAAGAGCAGAAGATCACCATCAAGGCTTCTTCTGGTCTG	['AAGATA', 'AGATAA', 'GGTAAA', 'TATCCT']
TTCAAGGTTATCATTGATACCTATCACAATCATATCCTTGATGAAGAAGCGATTAAATTTCTGGAGAAATTAGATGCCGAG	['ACAATC', 'CACAAT', 'TATCAT', 'TATCCT']
TTGTATAAATATTACTAAATGCTTGCTTAGTCGCATTGTTAAATGCAATACCGTATATTCGGTATGTAACAGCGATATCCT	['GTTAAA', 'TATATT', 'TATCCT', 'TGTATA']
TGGGGCGGCAGATCGCGAAAAAGTCGAGGAAGCTATCTCGCTGGTTGGCTTAAAACCGCTGGCGCATCGGCTGGTCGATAG	['AAGCTA', 'CTTAAA', 'GCTTAA', 'TTAAAA']
TGAAGGTCAATATGCCCATGTTTATTCTGTCGATACCGATAATTTTGGCGACAGCATTGCGTTGACCGATGCATTAATTGA	['ATAATT', 'CGATAA', 'GATAAT', 'TAATTG', 'TATTCT']
GCATGGCACAGCAGCTCTGAAACCATCGCTAAAATCAAATATGCGATGATCGGCGACCCGACTGGCGCCCTGACCCGTAAC	['CGCTAA', 'CTAAAA', 'GCTAAA', 'TAAAAT']
GTTCGTGGTAAAATAGCCAACCTGTTCGACAAAGATTATGAGACAGTCTATGGCTACCAAACTGCAGGACGGGAATACACC	['GGTAAA', 'GTAAAA', 'TAAAAT', 'TTATGA']
ATAGTACGGTGATGATGAAGCTGGAGGCCGTGGGGCTGCGTGGAGCGGCTAAACTAATGCCTTCTGAACTTTCCGGTGGGA	['CTAAAC', 'GCTAAA', 'GGCTAA', 'TAAACT', 'TAATGC']
TATATGCCGAGTTATTTGTCGCATAACCTGCATTACTCCGAAGACCACGGGGTGCTGATTATTATCGCCATTATGATCGGT	['TAACCT', 'TATGAT', 'TATTAT', 'TTATGA']
ACCGACCCGGCATCTATCGAATCTGTTCTGGAAAAAATTCGCGCAGAATTTGGTGAAGTGGATATCCTGGTCAATAATGCC	['AAAATT', 'ATAATG', 'TAATGC', 'TATCCT']
ATGGTTTACGCTATGATATCTGGAATGGAGTGACGGTGATTGCTTTTTGTGCCGTACTGTACAATATCTCTCTGTTATTTA	['ACAATA', 'CTGTTA', 'TACAAT', 'TACGCT', 'TATGAT']
TTGGAAGCATCACCATTTGTCTTATGTACGCAGACGGTAAAAAAGATCCACAACGGCGGTAAATTGAAAAATTAATTGCCA	['AAAATT', 'GGTAAA', 'GTAAAA', 'TAATTG']
GCCTCGATCCGCGCTTAAAAGATTGCGTCATTCGCGTCGCTTGTGATGTCACCAATCCGCTGGTGGGCGATAACGGCGCAT	['CGATAA', 'CTTAAA', 'GCTTAA', 'TTAAAA']
GTCAGTTGTTGATACGAATTTATCGTCACGATGATAATTGACTGATAAAGGGTTATTAGCTGATAAAGGGCTATTGACTGA	['ATAATT', 'GATAAT', 'TAATTG', 'TATCGT']
AATGTTGCTGTCTCACGCGCTAAAGATAGTTTTCTGGTATTTGGCGATATGGACCTTATCGAGATGCAGCCCGCATTTTCG	['AAGATA', 'ATAGTT', 'CGCTAA', 'GCTAAA']
GGAACTGGCGATTGGCGCAACACGCGCGATTCCGGTAGGCGGTCGTTATGCCTTCCGGGATATGGGGATGCTAAGCTGGAG	['ATGCTA', 'CTAAGC', 'GCTAAG', 'TAAGCT']
TTTAATCTGGAAGGCGTGGATCTGGAATTCCGTGACGAGGCGCTGGATGCTATCGCTAAGAAAGCGATGGCGCGTAAAACC	['ATGCTA', 'CGCTAA', 'GCTAAG', 'GTAAAA', 'TAATCT']
TATCATCGCTACTGGCTGGCAGAACACCACAATATGACTGGCATTGCCAGTGCTGCCACGTCGGTATTGATCGGCTATCTG	['ACAATA', 'ATATGA', 'CACAAT', 'TATCAT']
CAAAAGCTGCAGGACGGTAACTGGAGACAGGCAATAACGCAACTGGAAGCGTTAGATAATCGCTATCCGTTTGGTCCGTAT	['AGATAA', 'ATAATC', 'GATAAT', 'GTTAGA']
TTACCCGTCAATGTGCTGACAATCCGGTCAGCAATCCGTGCCTGTTTGAGTATGTATACTTTGCCCGCCCGGACTCGTTTA	['ACAATC', 'ATACTT', 'GACAAT', 'GAGTAT', 'GTATAC', 'TGTATA']
GACCAGAAAGGTGCAGTAGCCTCTCTGACTTCCGTTGCTAAACTGCCGTTTGCTTACGCTAAAGATGGTATCTCCTACACC	['ATGGTA', 'CGCTAA', 'CTAAAC', 'GCTAAA', 'TAAACT', 'TACGCT', 'TAGCCT']
GCAATGACGCGCGGTTTAAACTGTCTGTCGCTGTTTGCCGAACGGCTACAAGGGTTTTCTCCTGCCAGCGTCTGTATAGTT	['ATAGTT', 'TAAACT', 'TGTATA', 'TTAAAC']
TGCTAAAAAATCTTTTCTGAATGTAAAAAAGCTAGAAATCACACAGAAACTTCCAATGATGGGGTTCATACAAGGTGAATC	['AAACTT', 'AAGCTA', 'CTAAAA', 'CTAGAA', 'GCTAAA', 'GCTAGA', 'GTAAAA']
AAAGGTGCAATCTTTTGCACCTTTAACAGGTTAGCTCGGGCTAACATTCATGATTCTAAAACAAATAAATTATCTCTCTTT	['CTAAAA', 'GGCTAA', 'TAACAT', 'TCTAAA']
CTAATCTGCGATAAGCGTCGGTAAGGTGATATGAACCGTTATAACCGGCGATTTCCGAATGGGGAAACCCAGTGTGTTTCG	['ATATGA', 'CGATAA', 'TAAGGT', 'TAATCT']
ATCGTCGAAGATAAAGTGATCAAAAACCACTTTGCTTCTGAATATATCTACAACGCCTATAAAGATGAAAAAACCTGTGGT	['AAGATA', 'AGATAA', 'CCTATA', 'CTATAA']
GCAACGCGCTTTTGACAAAAAAGATAAAAATATCAATCACGAACAGGCAGAGCAAAAAGCTCTCGATAATGTCCCGCCGCT	['AAGATA', 'AGATAA', 'ATAATG', 'CGATAA', 'GATAAT']
CAGTTTACGCTGGTGGTTATTTGTACCCTCGTACTGTGGTTTCATAATGTCTACAGTTCGGCGCTGATGACAATTAACCAG	['ACAATT', 'ATAATG', 'CATAAT', 'GACAAT', 'TACGCT']
AGGTCTGGAAAACTGGAAAGTCGGTCCGGGTAAAATTGATATCGCGCTGGTTCGCGAAGATGTCGATGATTACGATCGCAG	['AAAATT', 'GGTAAA', 'GTAAAA', 'TAAAAT', 'TACGAT']
GCAGAAACCAAAGTGGCGATGGTGAACAAGTACGCGAGGGAGAATGAGCATCCATTGCTGTGTACGCTAGAAAAAGCCTGA	['CGCTAG', 'CTAGAA', 'GCTAGA', 'TACGCT']
AAAACCGCGAATGACTTCTACATTCCGGAAGATGAACCTTTCAAGATAATTGGCGCATTGCCTTATCTCTATGAGATCAAT	['AAGATA', 'AGATAA', 'ATAATT', 'GATAAT', 'TAATTG']
GGTGAAATTGACTGCAGCGGTAAAATGTTTGACTCGCTGGATCTAATTATTGCCGGTTTTCATGAGCCGGTTTTTGCGCCA	['AAAATG', 'GGTAAA', 'GTAAAA', 'TAAAAT']
CATAACGCCTGATGAGATAAGCGCTTAATGCGCTAGCTGGCAGGGGGAGTCCATTTCCTCAACCTCTTTACCGCTGAGGCG	['AGATAA', 'CGCTAG', 'GCTTAA', 'TAATGC']
GCGTTTGAAGGCTTAACCGCTGGGGTGAACTGGCGTATTTCCGGATATCGTAACGATGTCAGTGACTTGATCGATTATGAT	['GCTTAA', 'TATCGT', 'TATGAT', 'TTATGA']
TCTATAGCTGGGGCGGCGGTAGCCTGCTGCCGGTAGATACCAGCATCGTTCACTCCGTCGCGCTGGCTAAAACCACTGCAC	['CTAAAA', 'GCTAAA', 'GGCTAA', 'TAGCCT', 'TCTATA']
ATGCTGTTTGGTCTGGCGCAGGAAGGTGTGGCACCGAAAGCGTTCGCTAAACTTTCTAAGCGCGCAGTACCCGCGAAAGGG	['AAACTT', 'CGCTAA', 'CTAAAC', 'CTAAGC', 'GCTAAA', 'TAAACT']
GGCCTGACTCAAGGTACCGTTGTGACTATCTCCGCAGAAGGCGAAGACGAGCAGAAAGCGGTTGAACATCTGGTTAAACTG	['GACTAT', 'GTTAAA', 'TAAACT', 'TTAAAC']
ATCTGCCTGATGCGCTACGCTTATCAGGCCTACGCTAGCTGTGCAATCCATTGATTTTGCACAATTTTGTAGGCTGGATAA	['ACAATT', 'CACAAT', 'CGCTAG', 'GGATAA', 'TACGCT', 'TAGGCT']
AAATGGCTAAGTGGGCCGGAGTTCACGGTTGCGATACTCGGTGAAGAAATTTTACCGTCAATACGTATTCAACCGTCCGGA	['ATACTC', 'GATACT', 'GCTAAG', 'GGCTAA']
AATATATTGAATTCGCAAGGATTTGTAGGCCGGATAAGGCGTTCACGCCGCATCCGGCATGAACAAAGCACACTTTGCCAA	['ACACTT', 'CACACT', 'GGATAA', 'TATATT']
GGACTATCCTTCGGAAACGTTAACTGAGATCCGCCATACCGGCGCACGAGCCGGACTGGTATTTAATCCGGCAACCCCGAT	['CGTTAA', 'GACTAT', 'TAATCC', 'TATCCT']
CTGGCGAAAGATATCAAACAGCGTTTGCACGACGGCGAGATTGTATCGTTTGGTCTCGATCCATACTGCATGATGCTGGAG	['AAGATA', 'ATACTG', 'CATACT', 'TATCGT']
TTGGAAGCATCACCCTATTCTGCATACTCTTGAAAAGAAAGCATAACCTAAGCCCCTTAAAAGCATTCAGGATAATTATGA	['ATAATT', 'ATACTC', 'CATACT', 'CTAAGC', 'CTTAAA', 'GATAAT', 'GGATAA', 'TAACCT', 'TATTCT', 'TTAAAA', 'TTATGA']
CCAAATTTCAAACCTTACATGGAGGTTATTATAGTATATTTGACACCCTATATACCTGTGATTAGAGATGTGTATATATAT	['AGTATA', 'ATATAC', 'CCTATA', 'TAGTAT', 'TATATT', 'TATTAT', 'TGTATA']
GAGCATATACAAATATATTAGTCTAAGTTTTGTATGCTAACAGAAAGATATAATTTAGCTACCTATTCTAAAAATGGTGAA	['AAAATG', 'AAGATA', 'ATAATT', 'ATATAC', 'ATGCTA', 'CATATA', 'CTAAAA', 'TAGTCT', 'TATAAT', 'TATATT', 'TATTCT', 'TCTAAA']
TATAGCCTCAGTGATAAAGGCTTGCGCCTGACGCGACGGGCAGAAAGTAAAATTTATCGCGCAGAGCAACCTGCATGGGAT	['AAAATT', 'GTAAAA', 'TAAAAT', 'TAGCCT']
CGCGCAAACGTAGCATTCCGGGGATATCGTTTATACGTGATTACGCCGATAACCACGATTACATTAATGCACTGGCGAACA	['CGATAA', 'TAATGC', 'TAGCAT', 'TATCGT']
GGGATCCGATGATTGATGTGAACCTGACCGCCGCATTCGAGTTAAGCTATGAAGCTGCAAAAATTATGATCCCGCAGAAAA	['AAAATT', 'AAGCTA', 'TAAGCT', 'TATGAT', 'TTATGA']
AAAAAGATGCCTTAAACAGTACATTTTGGTTTGGAATTCTGTAGAAAGTATTTTGGTAAAAAAAAAAAAAAAAAAAAAGGG	['CTTAAA', 'GGTAAA', 'GTAAAA', 'TTAAAC']
AGAAATCTCAGCGCATCAGGATAAACTGCTACCTTAGGTCAACCACCAAAAGAAAATACAATACGTCCAGTTTGTATGCCT	['ACAATA', 'GGATAA', 'TAAACT', 'TACAAT']
TGCGCTGTTACCGCACCGGACGTTAAAAGAGGCAGAGAGCATCGCCGGTCAGTTAATCAAAGCCGTTGATACCTTGCCGAA	['CGTTAA', 'CTGTTA', 'GTTAAA', 'TTAAAA']
CATCTACGAGATAACTTTTTTAAACTGAATCGCGAACTGCACGATAAATCGCTGCGGTTGAATCTTCATCTGGATCAGGAA	['AGATAA', 'CGATAA', 'TAAACT', 'TTAAAC']
GGTCCGTCTAAAGACAACACTCCGATGTTCGTTAAAGGCGCTAACTTCGACAAATATGCTGGCCAGGACATCGTTTCCAAC	['CGCTAA', 'CGTTAA', 'GTTAAA', 'TCTAAA']
TACAGTACTTTAGCGGAGGAACTCTCTACTACCGTTCATGCGCTGGCTCTGCATACTTACACTATTAAGGAGTGGGAAGGG	['ACACTA', 'ATACTT', 'CATACT', 'TACACT']
TTCACGGTGCAGGGGGCAGCCTTGAGCAGGTCGGTAAAATTATGCTGCAACTGCTGCTGCCGTTTGTGTTGGGGCATCTTT	['AAAATT', 'GGTAAA', 'GTAAAA', 'TAAAAT']
AAGTGCTCTCTTTTATACAATATGCATTGCATCTGGACCTTAAACTTATAAAAATGGTCAGTGAAACTTCTGTGAACATGA	['AAAATG', 'AAACTT', 'ACAATA', 'CTTAAA', 'TAAACT', 'TACAAT', 'TTAAAC']
ATAGCGGCTCCCACAATGTTCAAATGTGGGAGCTATTTACCAGCACATCTTACACTTATGATGAGAACTCCTGGCGAATTT	['ACAATG', 'ACACTT', 'CACAAT', 'TACACT', 'TATGAT', 'TTATGA']
TTTAGACACCGGTGATATGCTCTATAAGCTCTCCTGCCCGATTACTGCAGAAGATACCAGTGGTACGCTGTACGACAAGCT	['AAGATA', 'CTATAA', 'TAAGCT', 'TACGCT', 'TCTATA']
CGATGCTGGCAGATGTTAAACCGGGTAAGAAGATAATTATTCTGGGAGCAGGTTGTATTGGTTTGATGACGTTGCAAGCGT	['AAGATA', 'AGATAA', 'ATAATT', 'ATGTTA', 'GATAAT', 'GTTAAA', 'TATTCT', 'TTAAAC']
CATTTGTTGCTGGGTGGCGATGGTAAATCGGCGGACTTTAGCCCACTGGCGCGTTACCTGAATGGCGATAACGTACGTCTG	['ATGGTA', 'CGATAA', 'GGTAAA', 'TAACGT']
CGATGCGTTGACCGATCATTCCAGTGAATTTATCGAGCAGCTGCACGATAAAATTATCGACCTTGAAGATAATCTCCTTGA	['AAAATT', 'AAGATA', 'AGATAA', 'ATAATC', 'CGATAA', 'GATAAT', 'TAAAAT', 'TAATCT']
GACCTGTTTATCCTCGCGGGTAACGTGGCGCTAGAAAACTCCGGCTTCCGTACCTTCGGTTTTGGTGCCGGTCGTGAAGAC	['CGCTAG', 'CTAGAA', 'GCTAGA', 'TAACGT', 'TATCCT']
CAAAGATGTGAGTAATAAAATTCTCACCAACCAGACCAACCTGACCTCGACGTTCTATACCGGTTCTATCGGTCATGATGT	['AAAATT', 'CTATAC', 'TAAAAT', 'TCTATA']
CAGTGCAACCTGCGTTTCGACGACACTAACCCGGTAAAAGAAGATATCGAGTATGTTGAGTCGATCAAAAACGACGTAGAG	['AAGATA', 'ACACTA', 'GACACT', 'GAGTAT', 'GGTAAA', 'GTAAAA']
TAACTGCAACGGTTAAAGATCAGTTCGACAATGAGGTGAATAATCTTCCGGTAACATTCAGCTCAGCCTCTTCAGGACTCA	['ACAATG', 'ATAATC', 'GACAAT', 'GTTAAA', 'TAACAT', 'TAATCT']
CGCAAAATGGCTCCCGCTCTTTTGACCGGTAATACCATCGTCATTAAACCTAGTGAATTTACGCCAAACAATGCGATTGCA	['AAAATG', 'ACAATG', 'TACCAT', 'TTAAAC']
GATAAAATGTTAGGCTGGCAACGCGCTGGTGGCGAAGGCATCCTGACGACAATCTACGGTATTCTGGTGTTTTTACCGTGG	['AAAATG', 'ACAATC', 'ATGTTA', 'GACAAT', 'TAAAAT', 'TAGGCT', 'TATTCT']
AATATCCGTTTATTGAACTGTTGATTAATGAGAATTACCCGCATCTCAATGAAGGAAAAGATAATCGCGGTCTTTTATCCT	['AAGATA', 'AGATAA', 'ATAATC', 'GATAAT', 'TATCCT']
GCTAAGGGCGGTAAAGTTGGTCTGTTCGGTGGTGCGGGTGTAGGTAAAACCGTAAACATGATGGAGCTCATTCGTAACATC	['GCTAAG', 'GGTAAA', 'GTAAAA', 'TAACAT']
CAGTACCTGACTAAGGAACTGGCTAAAGCGTCCGTATCTCGTATCGTTATCGAGCGTCCGGCTAAGAGCATCCGTGTAACC	['GCTAAA', 'GCTAAG', 'GGCTAA', 'TATCGT']
GGCGGACGTACTCCGGCCTCCTTCGAGCCGTCCATCGACTATGTGGTTACTAAAATTCCTCGCTTCAACTTCGAAAAATTC	['AAAATT', 'ACTATG', 'CTAAAA', 'GACTAT', 'TAAAAT']
TAATCATTTGCGGATAATCACCAACAGCCTGCGTGTGGCGCATATTCTTTACCACAACCCGCGCTTTGAAGTGATGGTGCC	['ATAATC', 'GATAAT', 'GGATAA', 'TATTCT']
CGCGCAGGCGCTGGAAACCTCGATGGTATGTGAAATCCCGTTCGAAACGCTGGACGATTTGTCCGGTAAAATGCCGAATCT	['AAAATG', 'ATGGTA', 'GGTAAA', 'GTAAAA', 'TAAAAT']
CACATACGGATAAAAATGCCATGGAAATCGTGGATGGTTTTCACCGCCATGAAATTGGTAAAGGCTCATCATCATTAAAAT	['AAAATG', 'GGATAA', 'GGTAAA', 'TAAAAT', 'TTAAAA']
AACGCCCTGCTGATTTGTAACGTTATTCGCTACAATGCGAACGACAACCCGACCAAGCAGACTGCATTCAGCCAGTATGAC	['ACAATG', 'AGACTG', 'TAACGT', 'TACAAT']
GTACATCAGGTAAAACTGACCGATAAGCCGCTTTCTTTTGGGTATAGTGTCGTGGACAGTCATTCATCTTTCTGCCCCTCC	['ATAGTG', 'CGATAA', 'GGTAAA', 'GGTATA', 'GTAAAA']
ATGCTTATTGGCTCCCACTGTGAAATCGTTTTGCACTCTTTGCAGGATCTAAAATGTTCAGCCATTCGCATTGCTAACGGT	['AAAATG', 'CTAAAA', 'TAAAAT', 'TCTAAA']
TGCTATGTGGGTAAAGATACTCACGCCCTGTCCGAACCTGCATTCATTTCCGTTCTGGAAGTGCTGGCAGCGAACGGCGTT	['AAGATA', 'ATACTC', 'GATACT', 'GGTAAA']
CTTAAAATTATTTGCTTCGCTGTTAATTTCACTTTCATATTCTAGTGCCTACGCAGATTTATCAGAAACAGTGTATATTAA	['AAAATT', 'CTGTTA', 'CTTAAA', 'TAAAAT', 'TATATT', 'TATTCT', 'TGTATA', 'TTAAAA']
TTGGAAGCATCACCAAGAATGCGATGGATGGTATATTTACGAAAAAATAATTGATGATAATTTTGCCATAGTCATAGAATC	['ATAATT', 'ATGGTA', 'GATAAT', 'GGTATA', 'TAATTG', 'TATATT']
GGTGGGCTTAAAATGACCGCTCGCGAAGTGATGGATATTGACGAAGCCCGGGAAAAATATGCTCGCGGGCTTGCTATCTCG	['AAAATG', 'CTTAAA', 'GCTTAA', 'TAAAAT', 'TTAAAA']
AGTGGTCGGTATACGCCTTAATTGTCGCGACTATTATTGGCCTGGGTGTACTGGCAAAAATTTATCGCAAAGCAGAAAACC	['AAAATT', 'GACTAT', 'GGTATA', 'GTATAC', 'TAATTG', 'TATTAT']
TTTGATGCAGGCGTCCGTCTGGGTGGGGAGATGGATAAAGATATGATCGCCATTCGAATCGGGCCAGATATACCAATGGCT	['AAGATA', 'ATATAC', 'ATATGA', 'GGATAA', 'TATGAT']
CAAACGCTGACCGAAGAAGCGGTGCGTCTGTATGGCGATAAGCTGACTAATGCCAACGTAGTTGATGATGTTATCGACTTT	['ATGTTA', 'CGATAA', 'TAAGCT', 'TAATGC']
GTCGATAAGGGTGGTTGTATTAACGTACTGACCACTCAACGTCCGTCTCCTCTCGCTAAGGGGAATCCGTCACATACAAAC	['CGATAA', 'CGCTAA', 'GCTAAG', 'TAACGT']
CCCTGTTACCAAAAACGCTTTTCACGACCGGTTATCGCTACACTAAATATTACGATGATGTCGAAGTCGATGCCTGGCAAG	['ACACTA', 'CTGTTA', 'TACACT', 'TACGAT']
ACCCAACTGGACGTTTTAATGACCTCGTTAAACAGCACCAGCAGCTACTTAACGCAGCAGTTCGAAAACAACAGTAATTCC	['CGTTAA', 'GTTAAA', 'TAATTC', 'TTAAAC']
AGCCCGTCGGCGGAACTGTTTTATGAAGACCTTGATGAAGCTGATAACATTGAGGTAATCCGCAAATTGCTGGATACACTC	['TAACAT', 'TAATCC', 'TACACT', 'TTATGA']
GAGTCCTTCCTGGCTGGCGCTACTGAAGCGACCACCACCCTGTGGGACAAAGTAATGGAAGGCGTTAAACTGGAAAACCGC	['CGTTAA', 'GTTAAA', 'TAAACT', 'TTAAAC']
AATTCAATTGGTTATCTGGTCACTGACGACAATGCGATGGTGTGGCGTGGACCGATGGCGAGCAAGGCGTTAATGCAGATG	['ACAATG', 'CGTTAA', 'GACAAT', 'TAATGC']
TTAAGCTAGCTAAAAATGCCAATAAAGTAAATAAAAAACTTGTATTACCTGACGAATATATAGCACTTGAATTTAAAGGTA	['AAAATG', 'AAACTT', 'AAGCTA', 'CTAAAA', 'GCTAAA', 'TAAGCT']
GAAAAAATGGTACGTAGCGGCACCGTGCTGCTGGTGCTCTCCGACCGGAATATCGCTAAAGATCGCCTGCCGGTTCCAGCC	['AAAATG', 'ATGGTA', 'CGCTAA', 'GCTAAA']
ACCGAGATGCAGGATGAGCTGGTAAAATTACAGGCGAAACATCAGCGCACCATTGTCTTTATTTCCCACGATCTTGATGAA	['AAAATT', 'GGTAAA', 'GTAAAA', 'TAAAAT']
ACCGCTAAACTTAGCGCCTACGGTACGCTGAAAAGCGCGCTGACGACTTTCCAGACCGCCAATACTGCATTGTCTAAAGCC	['AAACTT', 'ATACTG', 'CGCTAA', 'CTAAAC', 'GCTAAA', 'TAAACT', 'TACGCT', 'TCTAAA']
ATCGATACCGGTTCTAAAATGGACGAAGTTATCTACGAAGAGTTTAAAGGTACAGGCAACATGGAACTGCACCTCTCTCGT	['AAAATG', 'CTAAAA', 'TAAAAT', 'TCTAAA']
GGTATTCAACATCTGATATCTCCAACACCGATGACAGATCCAGGCGTCGGGGTTATCGTGACAATTGTGGCGCTAATTTGT	['ACAATT', 'CGCTAA', 'GACAAT', 'TATCGT']
AATGGAGATTGTGGAGATTGCACGTCAGCATAATCTCATTATCTTCGCCGATGAAATTTATGACAAAATTCTCTACGACGA	['AAAATT', 'ATAATC', 'CATAAT', 'TAATCT', 'TTATGA']
AAGAGGGTTGATGCCAGCATACAGGGGCGAAGCTGGTCAACAAGTCAACATTAAGATAATGGAATATTCGGAGAGAAACGT	['AAGATA', 'AGATAA', 'ATAATG', 'GATAAT']
GGCTACGATGAGAAAACCCTGCCAGCCAGTGCGCCGAAAAATGGCCACTATAAAGCTTATATTCTGGGTGAAGGGCCAGAT	['AAAATG', 'CTATAA', 'TACGAT', 'TATATT', 'TATTCT']
GATTATCCTAAAGTTACACACATTTGCTGTGTAAAACGAGGGGTTTTCCGCAGGCAGGAGAGCAAAATGCCACGCTCTGTT	['AAAATG', 'ATCCTA', 'GTAAAA', 'TATCCT']
AAAGACGAACTGGGAGATAATCTGTATATCGCCCAACTGGACGTTCGCAACCGCGCCGCTATTGAAGAGATGCTGGCATCG	['AGATAA', 'ATAATC', 'GATAAT', 'TAATCT', 'TGTATA']
AATATCCTGGGTTCAAAACCCGGAACGATCTTCACTATGTTAAGGGATACTGGCGGCATAAAACCCCATGAGCGTAAGCGG	['ACTATG', 'ATACTG', 'ATGTTA', 'GATACT', 'TATCCT']
AACGAATGTGAAACTTATGCTGAATTAAAATTGGGTCAGGAAGTGTGGAAAGAGGGCGATAAGAGCTTCTATTTCGACACT	['AAAATT', 'AAACTT', 'CGATAA', 'GACACT', 'TAAAAT', 'TTAAAA']
GACTGCCCGGGGCACGCCGACTATGTTAAAAACATGATCACCGGTGCTGCGCAGATGGACGGCGCGATCCTGGTAGTTGCT	['ACTATG', 'ATGTTA', 'GACTAT', 'GTTAAA', 'TTAAAA']
ATATTGCTGCGCTAAAAATTATTGCTCGCCGTAGCGAATAATTATATGCCTGGTGTGGCTTCGTACGCCGGATAAGACGCG	['AAAATT', 'ATAATT', 'CGCTAA', 'CTAAAA', 'GCTAAA', 'GGATAA']
GCTAAAAATGACCATTTTTACGGGAAACATTGTGCTGATGCTGGCGCTAATGGTTTCGTGAGTAAAAAAGAAGGCATGAAC	['AAAATG', 'CGCTAA', 'CTAAAA', 'GCTAAA', 'GTAAAA']
CTCGATAAGTCATTAAAACATATCGAAATTAACGGCGATAACCTGCATGACTATCTCGGTGTTCAGCGTTTCGACTATGGT	['ACTATG', 'CGATAA', 'GACTAT', 'TAACCT', 'TTAAAA']
GCGGCGTTTATTGATGGACCCATTAACCATACTGCCATCGACGGGATACCGGTATACCGCGAGGAACTGATGATCGTCACG	['ATACTG', 'CATACT', 'GGTATA', 'GTATAC']
AGGCATTAGGATTAAAATATGCTCCTGTAGATGGCGATGGATATTGTCTGTTAAGAGCTATACTGGTTTTAAAACAACATG	['ATACTG', 'CTATAC', 'CTGTTA', 'TAAAAT', 'TAGGAT', 'TTAAAA', 'TTAGGA']
GGGGTGATATCCCGGATGCGTGAATCCCTCAGAGCTAAGCTGGAGGCTGACCGTACCCGTAAGGTGCGTGAGGATAAACGC	['CTAAGC', 'GCTAAG', 'GGATAA', 'TAAGCT', 'TAAGGT']
ATGCCTTATTTTTATTGATCTGCTTTGTCTTACAATTAAGGTCCAAGAGCTTGGTTAAACTGTATTATTTGCCTAAGTATA	['ACAATT', 'AGTATA', 'GTTAAA', 'TAAACT', 'TAAGGT', 'TACAAT', 'TATTAT', 'TTAAAC']
ATTGCGATTGTCTTTGCTGCCAATTTTAGCGTTGGCGTTAACGTCATGCTTAAGCTGCTGGAGAAAGCAGCCAAAGTGATG	['CGTTAA', 'GCTTAA', 'TAACGT', 'TAAGCT']
GCCATCCGTAACCGCGTTAAGTCTCAGGCGATCGAAGGTCTGGTAAAAGCTAACGACATCGACGTACCGGCTGCGCTGATC	['AAGCTA', 'CGTTAA', 'GGTAAA', 'GTAAAA']
TTCGGCGAAAAATGGACCCAGCCTGGTAATATCGTCACCAACGGTGCCTATACCTTAAAAGATTGGGTCGTAAACGAACGA	['AAAATG', 'CCTATA', 'CTATAC', 'CTTAAA', 'TATCGT', 'TTAAAA']
GCGGTCATACCGCCAGTGGTGGTGATATGAACACACTACGCTTAGGTATTGATGGCATTAGTCAGGCGACACCGCTGGATA	['ACACTA', 'ATATGA', 'CACACT', 'TACGCT']
TGAACAACAATTTTATGAGACATCCAGCAAAGGCAAAATTCCTCTGTTGCAACGGTTATTAAGCTTGCATCAGCCATCCTC	['AAAATT', 'ACAATT', 'TAAGCT', 'TTATGA']
GGAGCATCGAGATGTTACGGATAAGCAACGAGGGGTCATATATGCTGGCAACCTTTCTAGGCATAAATGTTCTTTCATATA	['ATGTTA', 'CATATA', 'CTAGGC', 'GGATAA']
GTTAGAGTCATTACCGCTGTTGCTCAGTTTGCATAACTCGCCCTTTGTCATAGACGTGCTGCGTATTGTTCAGATAATGAG	['AGATAA', 'ATAATG', 'GATAAT', 'GTTAGA', 'TAGAGT']
GGAAGCGGCTTACGGCTGGCAGATGAAACGTGATGGTAAATATTTGCGCCGGGTGGTGGCGTCTCCGCAACCGCGTAAAAT	['ATGGTA', 'GGTAAA', 'GTAAAA', 'TAAAAT']
TTCATTTGGGAGCAAATACTTATTGCCTTGAAAAGTAGCACTGTAATAGCCTATGATAATTAGTTGTAGAATAACCTTTAT	['AGAATA', 'ATAATT', 'ATACTT', 'GATAAT', 'TAACCT', 'TAGCCT', 'TATGAT']
CCACAATAGTAAACTTGACTTAACAGATCTTCACTTGGGGTCTTTGCCACCTCTTCCATCCTGGATTGAGGTGCTTTATCT	['AAACTT', 'ACAATA', 'CACAAT', 'TAAACT']
GCGGAGCCGCGCACGCTGATTTTTTATGAATCTACCCACCGTCTGTTAGATAGCCTGGAAGATATCGTTGCGGTATTAGGC	['AAGATA', 'CTGTTA', 'GTTAGA', 'TAGCCT', 'TATCGT', 'TTATGA']
CGCCAGAGCGGATTTTTCGGCTATAGCCTCTATATTCTGTTATTCATCATTGCCACCCTCTTGCTGTTACCAGGAAGCATA	['CTGTTA', 'TAGCCT', 'TATATT', 'TATTCT', 'TCTATA']
GTTGACAGCATTTCTGTCAAACGTCGTGGTGCTGTTCGTAAAGCTAAACTGTACTACCTGCGTGAGCGTACTGGTAAGGCT	['AAGCTA', 'CTAAAC', 'GCTAAA', 'TAAACT']
TAATAATCAGGCCAATATCGCCATCGGCGCACCCGATACACTACTGGACGGCGGCGGTATTGATTACACTGAAATTGGCGC	['ACACTA', 'ACACTG', 'ATAATC', 'TACACT']
CACAATAACCAGGTGCTCAACAAAGTAAAAGCGGATAAATCGCTGGAAGCCAATAACGGTCACGATGGCACATGGATCGCT	['ACAATA', 'CACAAT', 'GGATAA', 'GTAAAA']
TCAAATGTTAACCGTACGATTGCTAACGTTCGCACAATTTTCAATAAAAAAGGCGGCAATATCGGAGCGGCAGGTTCTGTC	['ACAATT', 'ATGTTA', 'CACAAT', 'TAACGT', 'TACGAT']
CACCCAGGTGAAGTTTGCCCGGCTAAATGGAAAGAAGGTGAAGCAACTCTGGCTCCGTCTCTGGACCTGGTTGGTAAAATC	['GCTAAA', 'GGCTAA', 'GGTAAA', 'GTAAAA', 'TAAAAT']
GCGGAAGCGATTGAAGATGACGCTAAACGCCGCGAGCGCCAGCAAGAAACCGCCGTCGCTACGATGAAGCGCTTCCGCTGG	['CGCTAA', 'CTAAAC', 'GCTAAA', 'TACGAT']
CGGACGCAAAGCCAGGCGGTGCGGGCTGATATGCTACATTACCAGTCTGATGTTATGATGAACGGCGCAATTCTGCTGGCG	['ATGCTA', 'ATGTTA', 'TATGAT', 'TTATGA']
TATTCTACTCTGGAAGTAGAGTATTAATTATATTACTGGGAAGCCTTAACGCCATTATATTTATTTAATTGATGACATTAG	['GAGTAT', 'TAATTG', 'TAGAGT', 'TATATT', 'TATTCT']
CGACAATACTCAGGAAAATTTCTGGCCCTCATGGTACCGGCAACATGTTGAAGTGCTATGGACCACGCTCAATCAGTTCAA	['AAAATT', 'ACAATA', 'ATACTC', 'ATGGTA', 'GACAAT']
CCTGCTCGCCCGATGGTGGCTATCGTTGGTGGTTCTAAAGTATCTACCAAACTGACCGTTCTGGACTCCCTGTCTAAAATC	['CTAAAA', 'TAAAAT', 'TATCGT', 'TCTAAA']
TCGGCGTGGTGGGCACTGCTATTCTTAATCCCGTTTATCGGCTGGCTTATTATCATCGTCTTTAACTGCCAGGCGGGTACG	['TAATCC', 'TATCAT', 'TATTAT', 'TATTCT']
CGTCGCAAAAACTGGCCGATGTACAGACACTTTTGCATGAAGCGGGTGTGGCGGATAACGTGATTTGTTTTGAAGCGCAAA	['ACACTT', 'GACACT', 'GGATAA', 'TAACGT']
TTTGTTTCTTCTCCTTGATATAATCCTAAAAAAATCTCATAAAATTAATATATGAGATAATCTTTATTCAGCAGAAGATTA	['AAAATT', 'AGATAA', 'ATAATC', 'ATATGA', 'ATCCTA', 'CTAAAA', 'GATAAT', 'TAAAAT', 'TAATCC', 'TAATCT', 'TATAAT']
GACTATGATCAGAATCGGGCCATGTTAAACACCCTGAATGTTGGTCCAACCCTGGATCCGCGTTTTCAGACCTATCGCTAT	['ACTATG', 'ATGTTA', 'GACTAT', 'GTTAAA', 'TATGAT', 'TTAAAC']
TTAGCTATAATCTGGTACAGGGCCATAAAATCGCCACAGTAATCTCATACTCGCTTACTGTGGCGATCCCTCTTCTTCCGT	['ATAATC', 'ATACTC', 'CATACT', 'CTATAA', 'TAAAAT', 'TAATCT', 'TATAAT']
CCACTGGGGGATGACGTGATATTTATTCCGGGTCACGGACCATTATCCACACTTGGTTATGAACGCCTGCATAATCCCTTC	['ACACTT', 'ATAATC', 'CACACT', 'CATAAT', 'TAATCC', 'TTATGA']
GCTGCTCGTCTGGGAGTTTCGCAACCGACGGTGGCTAAAATGCTTAAGCGGCTGGCAACCATGGGGCTGATTGAAATGATC	['AAAATG', 'CTAAAA', 'GCTAAA', 'GCTTAA', 'GGCTAA', 'TAAAAT']
TTTTTCCACAGAAAGGAATTGTCGTTGTTACAACAATAATGAACGGATACTGACACAACATCGCTACACTTTTTAAAGCAC	['ACAATA', 'ACACTT', 'ATAATG', 'ATACTG', 'GATACT', 'TACACT']
TGGAGTTGTCATAAAAGCGGGGGAAGTCATTGCCCGTATTCATATGTATAAAATTGCAACATTAGGAAGCGGAAATCCGCG	['AAAATT', 'TAAAAT', 'TGTATA', 'TTAGGA']
GGAAGAAAATGCCCGTCTGCAATTACGCAAAGCCAGCGGCAATATCGTCACCTTCTATACTGGACTGGCGTTGTTTAATTC	['AAAATG', 'ATACTG', 'CTATAC', 'TAATTC', 'TATCGT', 'TCTATA']
CCATTGCCGCTCACAGTTTCAGCGCGCAAATCGCCCCCTTAACAACGGAAGCTAAAATTGTCCAGGATGCGGATCGGCTGG	['AAAATT', 'AAGCTA', 'CTAAAA', 'GCTAAA', 'TAAAAT']
GTCGATGCGGCTAACCTAATCAAACCGTTGCTCTCCAGCGGTAAAATTCGTGTAATTGGTTCGACAACCTATCAGGAGTTC	['AAAATT', 'GGCTAA', 'GGTAAA', 'GTAAAA', 'TAAAAT', 'TAACCT', 'TAATTG']
CATCACCTGAAGGTAAGTGCAAAGATAATCGATTCTTTTTCGATTGTCTGGCTGTATGCGTCAACGTGAAACCGGCACCGG	['AAGATA', 'AGATAA', 'ATAATC', 'GATAAT']
GCGGCAGTTTGGTATGCAGGAACCGGGTATTGGCGTTTATCGCCCGAACGATAATCCACTGATTGACTGGCTACAAACCTG	['ATAATC', 'CGATAA', 'GATAAT', 'TAATCC']
CGATAATGACTGCGTGATGCTGGCGCTGGCGGAGAAATGGCAAAATAATTCGCAGGAACGGGATTTCTGCGTGATCAACGT	['ATAATG', 'ATAATT', 'CGATAA', 'GATAAT', 'TAATTC']
CCGACGCCATTCTATACCTGATAATTCTTCCCGCGGCGTTCACGTTTAAAATCAGGAATGCTGCTCGCAAAATAAAAACGC	['ATAATT', 'CTATAC', 'GATAAT', 'TAAAAT', 'TAATTC', 'TCTATA', 'TTAAAA']
ACAACGGGCGTTCATCCACTGGCGCATTCAACTGGCGAAAAGTCTGACCGAGTATAATCGGGTCTATCAATCTGCATTCTC	['AGTATA', 'ATAATC', 'GAGTAT', 'TATAAT']
CTGCGTAAAGCTACCATCGTTAACGCGGGTAGCTCCGACTTCCTGGAAGGCGAACAGGTTGAATACTCTCGCGTCAAGATC	['AAGCTA', 'ATACTC', 'CGTTAA', 'TACCAT']
CACTCTGCTGGTTGAAACCGTTAAACAGTTCCACCGTTCCGGGCGTATCGTCGCGGCTATTTGCGCCGCGCCAGCCACCGT	['CGTTAA', 'GTTAAA', 'TATCGT', 'TTAAAC']
TATGGAGTTCATCGGTAATAATCCTAACGCCTTCCGGTTATTATTGCGGGAACGCTCCGGCACCTCCGCTGCGTTTCGTGC	['ATAATC', 'ATCCTA', 'TAATCC', 'TATTAT']
CTGGCTTCTCTGCATGCGCGCGTTAAAGTGCGTATCACCGAGTATGAAAAAGATGCTAACGGTGAATTAGTAGCGAAAACC	['ATGCTA', 'CGTTAA', 'GAGTAT', 'GTTAAA']
ATTAAAGATGTCGATTTAACACAATATGCGGATAAGTTAATTGCACGTTTTGCTAATCCGGCGCTGAAACATAAGACCTGG	['ACAATA', 'CACAAT', 'GGATAA', 'TAATCC', 'TAATTG']
TCGTATGGCGACTGCATGGTGGAGATGAACGATGTGTTCGCTAATCTGTATAAAACACTGGAGAAAAACGGTCAGCTTGAT	['ACACTG', 'CGCTAA', 'TAATCT', 'TGTATA']
GGCACCAATCCGTTCTGTGTGGTTTTCCCTCGTAAAGATAATTTCCCGCTGTTGCTTGATTACGCCACCAGCGCCATTGCA	['AAGATA', 'AGATAA', 'ATAATT', 'GATAAT']
GCGCAGTGCCCAGCCATCCCGATACTGCTGCTTTCACCAAATCCTTAGTGCTTCTTTCGTGTTTTTCTATTGTCATAATGG	['ATAATG', 'ATACTG', 'CATAAT', 'GATACT']
AGAACTTTTGTACACGTTTAAGCTATTATTATTAAAAAGTGTTTGCAAAATGGTCAAGATTATAATATTGCTGAATTATAT	['AAAATG', 'AAGCTA', 'TAAGCT', 'TATAAT', 'TATTAT', 'TTAAAA']
TCGGGAAAAACATGGGGGCACTGGGCGCTCTGTCTGTGGATATGACGCAGGCTAATTCCACACTTCCCGATGACAGTCAGC	['ACACTT', 'ATATGA', 'CACACT', 'GGCTAA', 'TAATTC']
TCTGATAGTTAACATTACAAGATATAAGTAATGGACGCACTCCCAATTAGTCTATTTAAATCGCCACGAGTTTAACTGACA	['AAGATA', 'ATAGTT', 'TAACAT', 'TAGTCT']
AATACTTCAACTTCTGGTTGCATGATTGTTTGTCCGTAAAAAGATAACGCGCCTGCCGGGTAGTAGCAGGCGCATTACGCA	['AAGATA', 'AGATAA', 'ATACTT', 'GTAAAA']
GAAGGCGCAATCAACGCGAAAACCGTAACCTATGACTTCGAGCGTCTGATGGATGGCGCTAAACTGCTGAAATGTTCAGAG	['CGCTAA', 'CTAAAC', 'GCTAAA', 'TAAACT', 'TAACCT']
CGCAAAGTAAAAATAGCCAAACATCTTCGTTATGGGATGCATTTGCCTATACGTTAGCCATTCTTTACTACGAAAATTTTA	['AAAATT', 'CCTATA', 'CTATAC', 'GTAAAA']
TGCCAATGGCACTGCCCGGTAGCTAAATGCGGAAGAGATAAGTGCTGAAAGCATCTAAGCACGAAACTTGCCCCGAGATGA	['AAACTT', 'AGATAA', 'CTAAGC', 'GCTAAA']
GGACGGCGTGATTGCCAACCTGAAGGGCGTTTGCGATCTGGCAGATAAATATGATGCCCTGGTGATGGTAGACGACTCCCA	['AGATAA', 'ATATGA', 'ATGGTA', 'TATGAT']
AAAAAAATGAAGAAAACCGCTGAAGATTACCTGGGTGAACCGGTAACTGAAGCTGTTATCACCGTACCGGCATACTTTAAC	['AAAATG', 'ATACTT', 'CATACT', 'CTGTTA']
CCGGTTAAGCTGGCATCTCACCGCGAATTCACTACCTGGCGTGCAGAGCTGGATGGTAAACCTGTTATCGTCTGCTCTACC	['ATGGTA', 'CTGTTA', 'GGTAAA', 'TAAGCT', 'TATCGT']
ACAGGTACGTTAATCGGAACGTTGAGCGCATTTCCTTTCTTTATGGCGCTTGAAGCACAATCTATTTTCTGGATAGTTTTC	['ACAATC', 'ATAGTT', 'CACAAT', 'CGTTAA']
