GAGGATTCAGCACGTTTTCCTTAATGTCATCTTTACCGGGAACCTAAACTAAAATTGGCGGCCGCGCATTCCCGGCGCGGG	['AAAATT', 'CTAAAA', 'CTAAAC', 'TAAAAT', 'TAAACT']
AATATTTTTCCCGCCGATTGTGCAAGGACAATCGGCAAACGGTGCAGTACACTGCGTTGATTGCGTGTAAAGGGATGAAAA	['ACAATC', 'ACACTG', 'GACAAT', 'TACACT']
CCAGACAGTGTTTCATAATTCCTCCATTTTTCTCCCTTATTGGCTGGCTACACTAGTATCATTCCGCGAAACGTTTCAGGA	['ACACTA', 'ATAATT', 'CATAAT', 'TAATTC', 'TACACT', 'TAGTAT', 'TATCAT']
CCGTTCACATATTGACACTCATCGGGAAAAAAAACATAAATTTAAGCCCAATCGAAAATAATTAAACTTAATCTCGTTTAA	['AAACTT', 'ATAATT', 'GACACT', 'TAAACT', 'TAATCT', 'TTAAAC']
TACAAATAATGCTGCCACCCTTGAAAAACTGTCGATGTGGGACGATATAGCAGATAAGAATATTGCTGAGCAAACCTTCAC	['AGAATA', 'AGATAA', 'ATAATG', 'TAATGC']
CCGCCATTCTGGTGGGGCTTTTTTTGTCTTACTTACTCAACAATGCGTTAAATTTCGACTGTTTAAGATATTTCGGCACGT	['AAGATA', 'ACAATG', 'CGTTAA', 'GTTAAA']
TGCAACACTATTATCTGGCGTTATGGCATTTTCCACCAATGCAGATGATAAAATAATTCTGAAACATATCAGCGTCTCGTC	['ACACTA', 'ATAATT', 'TAAAAT', 'TAATTC', 'TATTAT']
ACAACCCAATAATTCGTGTATCAGAGTTTAAACAGAGTTGTTTGCCACCATCTCAAATCTGTCGTGGATAAATCCTCCGTA	['ATAATT', 'GGATAA', 'TAATTC', 'TTAAAC']
GCGGTAGAAAAACGCACCACTGCCTGACAGGCCAGTTAAAAAAATGCTATAAAATTCAGCTTAATTTTTAACGGCAAGAGA	['AAAATG', 'AAAATT', 'ATGCTA', 'CTATAA', 'GCTTAA', 'GTTAAA', 'TAAAAT', 'TTAAAA']
GAAGGTTGCGCCTACACTAAGCATAGTTGTTGATGAATTTTTCAATATCGCCATAGCTTTCAATTAAATTTGAAATTTTGT	['ACACTA', 'ATAGTT', 'CTAAGC', 'TACACT']
TTGCAACATGATTTCATCTCTTTCATTGATAATGATAACCAATATCATATGATAATTTTTATCATTTGCAAGCCAGATAAA	['AGATAA', 'ATAATG', 'ATAATT', 'ATATGA', 'GATAAT', 'TATCAT', 'TATGAT']
ATGCGGGTTGATGTAAAACTTTGTTCGCCCCTGGAGAAAGCCTCGTGTATACTCCTCACCCTTATAAAAGTCCCTTTCAAA	['AAACTT', 'ATACTC', 'GTAAAA', 'GTATAC', 'TGTATA']
GGCAATAAGATAAACACGTTTCTTCATTGTTAATCCTTAATAACCTTTTTATTCTTTGCCACGGGTTCCGTGGCGGGAGAT	['AAGATA', 'AGATAA', 'TAACCT', 'TAATCC', 'TATTCT']
GTCTTTATTGCTGATGTTGATTTCTCAACCGAAAAGAAATATACTGTATAAAATCACAGTTATTATGAGAGGCTGCAAATG	['ATACTG', 'ATATAC', 'TAAAAT', 'TATTAT', 'TGTATA', 'TTATGA']
ATAGTACCAAATGGGAAAATGTTAAGTAAGTACTTCTCTATATTCTTCAGGTAAACTATCAGCTGATGGTTTATCTATACA	['AAAATG', 'ATGTTA', 'CTATAC', 'GGTAAA', 'TAAACT', 'TATATT', 'TATTCT', 'TCTATA']
AACAATATGATTTATTGGAGCTTTATTTAAAATTTTGCAGATAAATATATATAAATAAAAATCTGTTTTCGCCACATGCTT	['AAAATT', 'ACAATA', 'AGATAA', 'ATATGA', 'TAAAAT', 'TATGAT', 'TTAAAA']
AAAAGCACGAATATCGACATAGTTAGGCGCTGTTTAACTAACGCATGCTAGTTTAATGACATAAGGTAGGTGAAACGGAGA	['ATAGTT', 'ATGCTA', 'TAAGGT', 'TGCTAG']
CCTTATCCTGCATAGTAAACCGCAACGCCCCTGAGAGTGAGTATCATTTATAATGATAATTCAAACTATCACATAAATAAG	['ATAATG', 'ATAATT', 'GAGTAT', 'GATAAT', 'TAATTC', 'TATAAT', 'TATCAT', 'TATCCT']
TTACCCGACGTTGTAATCCAACATTGCGAGCGGCGTAAAGCCGCCGCTATACTAAAACAACATTTTGAATCTGTTAGCCAT	['CTAAAA', 'CTATAC', 'CTGTTA', 'TAATCC']
GTTGGTAGTAAAACATTATCTTCAAATCAATAATCATCATGAATGTTTTGTTTATAATTGGTTGATCCTACTTTCATTATG	['ATAATC', 'ATAATT', 'ATCCTA', 'GTAAAA', 'TAATTG', 'TATAAT']
AAGAACCAGGCGTTTCCTTGCTGAAGAAGAGTTGTAAATTCGGTCATGATAATAATTCTTAGTATTAATTCGGCAATCTGA	['ATAATT', 'GATAAT', 'TAATTC', 'TAGTAT']
ATGCAGATGTTTTGTGAATGTGTTGGTTGACATTCATATGAAAAAAATCATAATTCCATCATGTTTGTGTGGGGTCTTTTC	['ATAATT', 'ATATGA', 'CATAAT', 'TAATTC']
AACTGGTTTCTCCCGCCATCAGCGCGTTAAAGTCGCGATTTAAATCCGCGTAAAATTCTGTTTTGTTCATTATATAATCAC	['AAAATT', 'ATAATC', 'CGTTAA', 'GTAAAA', 'GTTAAA', 'TAAAAT', 'TATAAT']
CATAACCTGTTGCATGATTATTTATGATCTCAATTCTGCATTTTGTCAGTAAAATGCAATAATTTATTAAATATCAATAAA	['AAAATG', 'ATAATT', 'GTAAAA', 'TAAAAT', 'TAACCT', 'TATGAT', 'TTATGA']
GGGTTTTCATTTAACGTGACACTGTCACTTAAATACTGTGATTTCAGCTACGATTCCGGGAGATTCCTTCCTTAACTTCCC	['ACACTG', 'ATACTG', 'CTTAAA', 'GACACT', 'TAACGT', 'TACGAT']
CAAAATTGCACGGACAGGGACTGTTAAAATGCCAAATTTCCTGGCATCATGGCAACCATCTGAACGGAGAGATGCCGGAGC	['AAAATG', 'AAAATT', 'CTGTTA', 'GTTAAA', 'TAAAAT', 'TTAAAA']
TTCAGCCTTCTTCAGGGCTGACTGTTTGCATAAAAATTCATCTGTATGCACAATAATGTTGTATCAACCACCATATCGGGT	['AAAATT', 'ACAATA', 'ATAATG', 'CACAAT']
TTGTGTTAATGGACGTCAATACATCTGGACATCTAAACTTCTTTGCGTATAGATTGAGCAAATCCCAAATAGCCGTTAAAA	['AAACTT', 'CGTTAA', 'CTAAAC', 'GTTAAA', 'TAAACT', 'TAGATT', 'TCTAAA', 'TTAAAA']
AAAACAGCGGATACGCGACATCCAGCGTGCAAGACGTGGCTGAAGACACTAAAATTTGCCAACCTGGCTACATAATGCCGC	['AAAATT', 'ACACTA', 'ATAATG', 'CATAAT', 'CTAAAA', 'GACACT', 'TAAAAT', 'TAATGC']
TCATCCAATTTAGCTGAAATCTTATTTATACTTTGTACAATTTTAGCGTATATTGTACAAAGTATTATTGGGTCGTGTACA	['ACAATT', 'ATACTT', 'TACAAT', 'TATATT', 'TATTAT']
CTACCAAAAATAGTTGCGCAAACATCTTGAAATTTTGCTAATGACCACAATATAAGCTAAACGCGATTCGCAACCCATTCA	['AAGCTA', 'ACAATA', 'ATAGTT', 'CACAAT', 'CTAAAC', 'GCTAAA', 'TAAGCT']
CGTAAAATTCAGGGAAACTCTTTTACAAGCCGCTAACTTTTCGTTAGCGGCTTTTTTTTTGTTCAGCAACGCACTACCATA	['AAAATT', 'CGCTAA', 'GTAAAA', 'TAAAAT', 'TACCAT']
TTGCCGCTAATCAGCCATAAAATCATTTGCAGATGCGCTCTGTCGAGGTAGTCTCATAAGGTTCGTTTATAGATCGACGGC	['CGCTAA', 'TAAAAT', 'TAAGGT', 'TAGTCT']
GTTCGCCCGGCCACATCATTAACGGATTAATGATAAGTGGATCAGATGTATAAAAAATTAAAATTAACCACAATAAGCGAA	['AAAATT', 'ACAATA', 'CACAAT', 'TAAAAT', 'TGTATA', 'TTAAAA']
GTTCGTGAATTTACAGGCGTTAGATTTACATACATTTGTGAATGTATGTACCATAGCACGACGATAATATAAACGCAGCAA	['CGATAA', 'GATAAT', 'GTTAGA', 'TACCAT', 'TAGATT']
GTGAGGAAATTTACCCCGGCCAGGCGGTAAAGTTCTGCCCTTACGCGCCGATAATCTTTGTCGAGTCCGGGCAGCATCACT	['ATAATC', 'CGATAA', 'GATAAT', 'GGTAAA', 'TAATCT']
TTTTAGTATTGATGGAAGGTGATTATTGAACAGTAACATCGAGTCACGGTAAAAATGTGAGGTATACAATGGACATTGAAT	['AAAATG', 'ACAATG', 'GGTAAA', 'GGTATA', 'GTAAAA', 'GTATAC', 'TAACAT', 'TACAAT', 'TAGTAT']
TTGTTCATTATATAATCACTTGGTTGTCTTACCTGGATCTGCCAGCCTATTAAAATAAGCATTAAATGCGTTAATGCTCAA	['ATAATC', 'CGTTAA', 'TAAAAT', 'TAATGC', 'TATAAT', 'TTAAAA']
GATTCTCTGCTGCGTTTCATAACCTGGCTGAAATCTTAAACCAATGCCTTATATTCACCTGCAAATGCACTGTTGGAAGAG	['CTTAAA', 'TAACCT', 'TATATT', 'TTAAAC']
TTATTAATCTGTTAACATTACGTTATCTAAAATATCTGGTAAAAAGTGGACTAAACGGTCAAAACAGTTGCACATAAAACA	['CTAAAA', 'CTAAAC', 'CTGTTA', 'GGTAAA', 'GTAAAA', 'TAAAAT', 'TAACAT', 'TAATCT', 'TCTAAA']
CGCCCACATCACCGACTAATGCATACTTTGTCATTCTTCAACTGCTCCGCTAAAGTCAAAATAATTCTTTCTCACACTGTA	['ACACTG', 'ATAATT', 'ATACTT', 'CACACT', 'CATACT', 'CGCTAA', 'GCTAAA', 'TAATGC', 'TAATTC']
ACAATTCGAGCTTTATTAACAGATTCCGCGAATGAATAGTTTTACTGGTATACTGCGTGTCTTGCGCTTTGTTGCGGTGCC	['ACAATT', 'ATACTG', 'ATAGTT', 'GGTATA', 'GTATAC']
ATAACACCCGGGAAGGCACTCAGTTGACGATTAGCGGTCATCCTGTTCTTAAAATGTAAAAAAATCACGCTTCAGGGCTAA	['AAAATG', 'CTTAAA', 'GGCTAA', 'GTAAAA', 'TAAAAT', 'TTAAAA']
TCACGTTGTAAATTGTTTAACGTCAAATTTCCCATACAGAGCTAAGGGATAATGCGTAGCGTTCACGTAACTGGAGGAATG	['ATAATG', 'GATAAT', 'GCTAAG', 'GGATAA', 'TAACGT', 'TAATGC']
TCGTTTCGGTGGTGATGCGTAATCATCGCTGAACAGCGAACACAATCTGTAAAATAATATATACAGCCCCGATTTTTACCA	['ACAATC', 'ATATAC', 'CACAAT', 'GTAAAA', 'TAAAAT']
GCGCGTATAGCATCGACCGCCTGCTGAATAAAAAGTGGTAAGCACGCGCTATACTTAACGATAAAAAACGAGGAGGAAGCT	['ATACTT', 'CGATAA', 'CTATAC', 'TAGCAT']
ATTGTTAACTGGTTAACGTCACCTGGAGGCACCAGGCACTGCATCACAAAATTCATTGTTGAGGACGCGATAATGAAAACG	['AAAATT', 'ATAATG', 'CGATAA', 'GATAAT', 'TAACGT']
TTTCGTAATTACATTAATTAAAAAACTTAAAATCATTAAATAAATAAAAAACCACTAACTCTATGTGAAATAAATCAAAAT	['AAACTT', 'CTTAAA', 'TAAAAT', 'TTAAAA']
AGATTTGCAGTTTTTCCAGAAGAGCGCGACGCCATGGCGAGGTGGAGGCTAAAATAAGTTTAGGCATATTTTTTTCCATCA	['CTAAAA', 'GCTAAA', 'GGCTAA', 'TAAAAT']
CGCTTTACATCGGTAAGGGTAGGGATTTTACAGCACCGTGAAAAATCTCATAATTTTTATGAAGTCACTGTACTCACTATG	['ACTATG', 'ATAATT', 'CATAAT', 'TTATGA']
CTTTAAAAAATGAAAACGTAAAAAGGTTGGGTTTCGATGTATTGACGGGTAAACTTTGTCGCCCGCTAAACATTTGTTTAA	['AAAATG', 'AAACTT', 'CGCTAA', 'CTAAAC', 'GCTAAA', 'GGTAAA', 'GTAAAA', 'TAAACT', 'TTAAAA']
GCATATAAAACAAATTACACCGATAACAGCGAATATTACGCTAATGTCGGTTTTAACGTTAAGCCTGTAAAACGAGATGGT	['CATATA', 'CGATAA', 'CGCTAA', 'CGTTAA', 'GTAAAA', 'TAACGT', 'TACGCT']
AGGTTGTTTTCATTGGCACTCATGCTATTTTCCACCCATTCACAGTGACTATATTGATCCACAATTGCGTGTATCATAGAT	['ACAATT', 'ATGCTA', 'CACAAT', 'GACTAT', 'TATATT', 'TATCAT']
GAAATCTATAGCGCATTTTTCTCGCTTACCATTTCTCGTTGAACCTTGTAATCTGCTGGCACGCAAAATTACTTTCACATG	['AAAATT', 'TAATCT', 'TACCAT', 'TCTATA']
AAATATTTACTAAAAAATCCGCATGTTTACCCCATTCGTTTGCCGCTTTACACTAGTCGCGAATTTAAAACAGAGGTGGTA	['ACACTA', 'CTAAAA', 'TACACT', 'TTAAAA']
GGCCACGCCAATGATTTTTCCCCAATACTGCATATATTCCCCAAATCGACACACGGATATCAGGGCTATCTCCCACAATAT	['ACAATA', 'ATACTG', 'CACAAT', 'CATATA', 'TATATT']
AAGTTTTACCTTACAACCTTCGTAAGACAACTTTGTGAACTTTGCACCGCCAGCGGCGATAAAAAGTAAAATGGCCCCCTT	['AAAATG', 'CGATAA', 'GTAAAA', 'TAAAAT']
GGTGGTGCGGGTGTAGCCAGCGCTAAAGGTTTTCTCGCGTCCGCGATAGCGTAAAATAGCGCCGTAACCCCCAGGTCCTGG	['CGCTAA', 'GCTAAA', 'GTAAAA', 'TAAAAT']
AGATTGATATTTAATATATTAGCGTAACTGTTATGCTGTTATCTATATTATGTGATCTAAATCACTTTTAAGTCAGAGTGA	['CTGTTA', 'TATATT', 'TATTAT', 'TCTAAA', 'TCTATA']
CACTCCGGGTAATGCATTCCAATACTGTATATTCATTCAGGTCAATTTGTGTCATAATTAACCGTTTGTGATCGCCGGTAG	['ATAATT', 'ATACTG', 'CATAAT', 'TAATGC', 'TATATT', 'TGTATA']
TGCGCATCTTTTGTCTCGATATACATTTTCTGACATCCTCATCCGCTATGCTACAGGCACTAAAAATGGTTATTGAGGAGC	['AAAATG', 'ATATAC', 'ATGCTA', 'CTAAAA']
TCGAAACAATTCTTATGGTCAGGCTGGCGAACTAAGCGCCTTGCTATGGGTCACAATGGGCGGTTTCATTTGGCTGACGCT	['ACAATG', 'ACAATT', 'CACAAT', 'CTAAGC']
TTACACTCCGATGGAGTTTGTTATTGACGTGTTACAAAAATTCTTTTCTTATGATGTAGAACGTGCAACGCAATTGATGCT	['AAAATT', 'TACACT', 'TATGAT', 'TTATGA']
TTATCATTTGCAAGCCAGATAAATCCCTTGCTATCGGGTAAACCTATCGCTATGATTAGCAATCATTATCATTTAGATTAC	['AGATAA', 'GGTAAA', 'TAGATT', 'TATCAT', 'TATGAT']
GGTGACGGCGACCTCACATTGTGGCAGTCTTTGCAGCACGAAAATGGAAGTATAATGAGGACAAAATGATGACTATCGTTC	['AAAATG', 'AGTATA', 'ATAATG', 'GACTAT', 'TATAAT', 'TATCGT']
AATTCCTCTTTATAAGATAATCAGGGCTTTATTTTCAGCCCTGGTTGTTTTATATTCATCGCTGTTGCTTATTTAGACATT	['AAGATA', 'AGATAA', 'ATAATC', 'GATAAT', 'TATATT']
TTTAACGATAACGCCATTGAGGCTGGTCATGGCGCTCATAAATCTGGTATACTTACCTTTACACATTGGGGCTGATTCTGG	['ATACTT', 'CGATAA', 'GGTATA', 'GTATAC']
CTCGCAAGAACGGAGAGCCGTCGATTGACACTAAGGGCGGAGTGACATAATTTCAGGAGTGAGGGTTAGGGAGAGGTTTCC	['ACACTA', 'ATAATT', 'CATAAT', 'GACACT']
AATTATTCCTACACTATAATCTGATTTTAACGATGATTCGTGCGGGGTAAAATAGTAAAAACGATCTATTCACCTGAAAGA	['ACACTA', 'ATAATC', 'CTATAA', 'GGTAAA', 'GTAAAA', 'TAAAAT', 'TAATCT', 'TACACT', 'TATAAT']
CTAACTTCTTGTTTACTAGTAAGCTGTTGAAAGAAATGGTAATTTACGATAATGTTTTTTACCAGAATTCAGGGCGCAGAT	['ATAATG', 'ATGGTA', 'CGATAA', 'GATAAT', 'TAAGCT', 'TACGAT']
TCATCGCAAACAGTGCATAACATATATTAACAATATGTTTCTGCGTTATTTATCATTATTACAGGAGTTTTAATTTAAATG	['ACAATA', 'CATATA', 'TAACAT', 'TATATT', 'TATCAT']
CAAAAAGTCGTACTAGTCTCAGTTTTTGTTAAAAAAGTGTGTAGGATATTGTTACTCGCTTTTAACAGGGCAACGGAACAC	['GTTAAA', 'TAGGAT', 'TAGTCT', 'TTAAAA']
AACTCGTCTTTTGCAGGATTTTAGCTTGTTTCATGGCTTAAACGTCATTTATTCTCTTGAGTCGTCGAAATCGTCGCTAAG	['CGCTAA', 'CTTAAA', 'GCTAAG', 'GCTTAA', 'TATTCT', 'TTAAAC']
GCTGATTAAGAATTGACTGGAATTTGGGTTTCGAGGCTCTTTGTGCTAAACTGGCCCGCCGAATGTATAGTACACTTCGGT	['ACACTT', 'CTAAAC', 'GCTAAA', 'TAAACT', 'TACACT', 'TGTATA']
ATATTGAACAACGATTCGGACAAGGATGTAAATAATGAAAAGGATGACATATTCGAAACGATAACGGCTAAGGAGCAAGTT	['ATAATG', 'CGATAA', 'GCTAAG', 'GGCTAA']
TTTAAAAATGAATTATTAATTATTATCGTGTTGATAATGGTACGACAAGGCAACATAACACCTTACCTACAAAACAGAAAA	['AAAATG', 'ATAATG', 'ATGGTA', 'GATAAT', 'TATCGT', 'TATTAT', 'TTAAAA']
GAATATTCTTATAAACCTGTAAGCTGTTAAAGATTACCCGTCCCTTGCCGATAAATAAGCAACACATGATAAAAGCGCCCT	['CGATAA', 'CTGTTA', 'GTTAAA', 'TAAGCT', 'TATTCT']
TTAGCGATAATTTGTCATTTTAGCTTGATTCAACATAACAATAAAAACGGTAAGGTACAGCCTCGTTTGTAACAATGAGAA	['ACAATA', 'ACAATG', 'ATAATT', 'CGATAA', 'GATAAT', 'TAAGGT']
CCGAAATTTGCTCGTATCTACAATGTAGATTGATATATACTGTATCTACATATGATAGCGGTTTGAGGAAAGGGTTATGAT	['ACAATG', 'ATACTG', 'ATATAC', 'ATATGA', 'TACAAT', 'TAGATT', 'TATGAT', 'TTATGA']
GTCAAGCAAATCTATTGCCAGATTGACGAAAGCGTCACACTGTACCTGATAAAATCCGATACGCAACTTTATTAGCATGCA	['ACACTG', 'CACACT', 'TAAAAT', 'TAGCAT']
GTACTTTGCCTGGATGCGCTTTCAGTTTTGAGACAAATGAAGTTTTAGTAACTTCTTTAAAATCAATAGCTAAAATAAGTA	['CTAAAA', 'GCTAAA', 'TAAAAT', 'TTAAAA']
CACATTTAATCCATTTTGTAGATGATTGAGTATTCGCGGTAGTTATGATTAGATTGTTTTCGCAACAAAAACATTATGGAT	['GAGTAT', 'TAATCC', 'TAGATT', 'TATGAT', 'TTATGA']
CGTTATTTGTCTGATTTTGTTTGATTTTTGTTTAATTGGTTAGATTGATATATGCTGATAGTTGGCATGATAAATAGGTAT	['ATAGTT', 'GTTAGA', 'TAATTG', 'TAGATT']
CGCAAAGCTGACCGCACAAAAGGGGAGTGCTTTTCTGTGCTTAGCGGTTAGAATAGTCTCATGACTATATCTGGAGTTGAC	['AGAATA', 'GACTAT', 'GTTAGA', 'TAGTCT']
AAGTGCCAGATTACATTCATCTGCCGCTGGCGCTTAATCCACAAGGCGCTAAACTTTCCAAGCAGAATCATGCGCCTGCGT	['AAACTT', 'CGCTAA', 'CTAAAC', 'GCTAAA', 'GCTTAA', 'TAAACT', 'TAATCC']
AGATACGTAAAATTAGGTAAAGGGATGGCCTTGTTCTTGAAGGCTATTTAGAATCTCTTCACTTGCTTTTTTTCTGCTCTG	['AAAATT', 'GGTAAA', 'GTAAAA', 'TAAAAT']
TATAGGCCAACGCAATTCATATAGCCGTTGATACCTAATGTGATTACACTAGTAAAATATATTGTTACTTTACTATCGTTT	['ACACTA', 'CATATA', 'GTAAAA', 'TAAAAT', 'TACACT', 'TATATT', 'TATCGT']
TCCACAGCACTAAATCTCTCCCCGCCACCCCGTACCTCTGATAATGGTCTAAAATCATTGAAGCCACTTGCGACGACGTTG	['ATAATG', 'CTAAAA', 'GATAAT', 'TAAAAT', 'TCTAAA']
TGCACCTAAATCGTGATGAAAATCACATTTTTATCGTAATTGCCCTTTAAAATTCGGGGCGCCGACCCCATGTGGTCTCAA	['AAAATT', 'TAAAAT', 'TAATTG', 'TATCGT', 'TTAAAA']
CAGGTATCGTATTAATTGATCTGCATCAACTTAACGTAAAAACAACTTCAGACAATACAAATCAGCGACACTGAATACGGG	['ACAATA', 'ACACTG', 'GACAAT', 'GACACT', 'GTAAAA', 'TAACGT', 'TAATTG', 'TATCGT']
AACCATGCAGCTAATACGAATGAATGAGAGCAAAAGCGGGAAATATGTCTATATGTTAGTAAGTATGATTAAAGAAAAATT	['AAAATT', 'ATGTTA', 'TATGAT', 'TCTATA']
TGGAATAAGCAATTCCATTTGAATATAAGAGCCAGCTCACAGTTCTGTTAATCTTGCGCCAACACTATGACTGCTACGCAG	['ACACTA', 'ACTATG', 'CTGTTA', 'TAATCT']
TAGCGTCGCTTGTCAATGTAAGTTGTTGATACATAATATTTATATATGATTAATCAACGGATGATTCACATGAAGAATACT	['AGAATA', 'ATATGA', 'CATAAT', 'TATGAT']
TGGTAGACAGTACCCGACACGGAACATTTAAAAAAATGAATGTTTTTATATTCTAGATTCGATATTTTCGATAGGTTTGGG	['AAAATG', 'TAGATT', 'TATATT', 'TATTCT', 'TTAAAA']
AACCGCGTTAAATTCACGCCCTTCTCTTTTGACATTTCTTTTGCACTGGTAAACTAAATCACTTTTTTTTGTCCCAGGCTC	['CGTTAA', 'GGTAAA', 'GTTAAA', 'TAAACT']
TGTGCACCCACGACTAAATTTCCCCCCCTTTAAACTTCTCAATAATGTCACCAATTTTCTGGAAATCCTATGATGCCTTTC	['AAACTT', 'ATAATG', 'ATCCTA', 'TAAACT', 'TATGAT', 'TTAAAC']
ATCGCAAAAACCTCAGTAAAAATCTTGCTGGAGCTATTATTGCTAAGTAACATTTACCCCCTGAAGTTAATGGATCAATCA	['GCTAAG', 'GTAAAA', 'TAACAT', 'TATTAT']
TGAATGAATAATTTACTAATGTTTATTTAAAATATTTCAATGTCGTTATATAAATTACCTATAAAAAATAACCATGTATTT	['ATAATT', 'CCTATA', 'CTATAA', 'TAAAAT', 'TTAAAA']
AAATGACAATACTGATAGCCATTCCTCATAATTCTTACTCGCACCGGAATAATTTACACGTTTGGTTCGGTTTTTTTGGGG	['ACAATA', 'ATAATT', 'ATACTG', 'CATAAT', 'GACAAT', 'TAATTC']
AACCGGGCATTAATCCCAAAATGTTGCAGCAATAAACCGGTGTGACGAGTATCCTCGGCGGCAATCAGATCAACGGCCTGT	['AAAATG', 'GAGTAT', 'TAATCC', 'TATCCT']
ATGAAGAAAACTTGCGAGGTGTCTCGATGAACTGAAAAATGGCACAGTATAATTTATTCTACAGGTTATATTGGAAGCAAA	['AAAATG', 'AAACTT', 'AGTATA', 'ATAATT', 'TATAAT', 'TATATT', 'TATTCT']
TAGACAAATCGGTTGCCGTTTGTTGTTTAAAAATTGTTAACAATTTTGTAAAATACCGACGGATAGAACGACCCGGTGGTG	['AAAATT', 'ACAATT', 'GTAAAA', 'TAAAAT', 'TTAAAA']
TATTATTTACACTAAATCTGATTTGATATATTGATACTTAAAACATTTGATGCTTCCTTTGTCACTTTTTTGATGGAAGTT	['ACACTA', 'ATACTT', 'CTTAAA', 'GATACT', 'TACACT', 'TATATT', 'TATTAT', 'TTAAAA']
ATTACGCGGTTAATGGTAGTTTTGATTGATGTATAAGGCGATTGAGTATAGAATCTCGCCCGCTTTTGCATACGCAAAGCA	['AGTATA', 'ATGGTA', 'GAGTAT', 'TGTATA']
TATTTTATCTACAAAAACTGACTAAATAAAAATTTTTCACTAATTGATTAGTCATAGCCAGCGATATACGCTATGCGAAAA	['AAAATT', 'ATATAC', 'TAATTG', 'TACGCT']
TACATAGCATGCAAGAGCATGGCGTTTGTATGGCAACGTTATTATAATTAACAGTTGCTACTCCATTTAAGTTCACTCAGA	['ATAATT', 'TAGCAT', 'TATAAT', 'TATTAT']
GTCAGCCAGCAGGGCAACCAACTGACACTGAAAAATCCTACCGCGTATTATCTGACCATTGCCTATCTGGGGAGAAATGAA	['ACACTG', 'ATCCTA', 'GACACT', 'TATTAT']
ACGTAAAAAAACCCGCCCCGGCGGGTTTTTTTATACCCGTAGTATCCCCACTTATCTACAATAGCTGTACTCTTTTTGTTC	['ACAATA', 'GTAAAA', 'TACAAT', 'TAGTAT']
ACGCGACAGCGCGCAATAACCGTTCTCGACTCATAAAAGTGATGCCGCTATAATGCCGCGTCCTATTTGAATGCTTTCGGG	['ATAATG', 'CTATAA', 'TAATGC', 'TATAAT']
GCAGCGTAAATGAGAGTAAAAGCGTAAGCTGAAACTGGCAGGCTCCGCTAAAATTACTACGCTTAAGAGATAAAATCTCTT	['AAAATT', 'AGATAA', 'CGCTAA', 'CTAAAA', 'GCTAAA', 'GCTTAA', 'GTAAAA', 'TAAAAT', 'TAAGCT', 'TACGCT']
CATTTATCCTCGCGGGGTATCATGACGTCGAAACCTGCCGTGACTATGGTGATAACGAGCGCGTAACGCTCGGCCGCTATT	['ACTATG', 'GACTAT', 'TATCAT', 'TATCCT']
AGTTGTTTTCTTGCGATTTTGTCTCTCTCTAACCCGCATAAATACTGGTAGCATCTGCATTCAACTGGATAAAATTACAGG	['AAAATT', 'ATACTG', 'GGATAA', 'TAAAAT', 'TAGCAT']
TAATTTTTCCTCTATTCTCGGCGTTGAATGTGGGGGAAACATCCCCATATACTGACGTACATGTTAATAGATGGCGTGAAG	['ATACTG', 'ATATAC', 'ATGTTA', 'CATATA', 'TATTCT']
CCCTTCATTTCTAATAACCCTATAATTAATCAACGAAATTATAATGTTTCTAAAATTAGAATATAATTTATAAACATTATT	['AAAATT', 'AGAATA', 'ATAATG', 'ATAATT', 'CCTATA', 'CTAAAA', 'CTATAA', 'TAAAAT', 'TATAAT', 'TCTAAA']
TTCAAAATGACCGTTGCTCTCTGATTTCTCATTTCATGCTCACCCAATATGATGGCGGCGTTTTCTAAAACTGTTAAAGAA	['AAAATG', 'ATATGA', 'CTAAAA', 'CTGTTA', 'GTTAAA', 'TATGAT', 'TCTAAA']
AGGAAATCGCCCCATGGGGTTGGCAGTTTGGCTTCTGCCACACGTTTAAGCTGCATGAAATTCTCCAGATAATGCTGGTTC	['AGATAA', 'ATAATG', 'GATAAT', 'TAAGCT', 'TAATGC']
GTGTCTTACGACATGCTTACCTTAATCGTTCCCAGTGTGCCTATAGCAGATATTCTAAACATGTCGATAATTCATTACGCA	['ATAATT', 'CCTATA', 'CGATAA', 'CTAAAC', 'GATAAT', 'TAATTC', 'TATTCT', 'TCTAAA']
AAGTTGCCAGTAAGGCGCTCTTGCCACCAGCGTGGTATATTTGTCTGCAAGCCATGCCTGGCGTAGACTAATGTCCTTGTT	['AGACTA', 'GGTATA', 'TAGACT', 'TATATT']
GCTAAAAAGTAACCAATAAATGGTATTTAAAATGCAAATTATCAGGCGTACCCTGAAACGGCTGGAATAAACCGTTTTCAG	['AAAATG', 'ATGGTA', 'CTAAAA', 'GCTAAA', 'TAAAAT', 'TTAAAA']
TTTCATGTAAAAGAATAAAATATCTGTATAAAATCATGCCACTGGCAATCTGCATCAACTCTCCGGGTAAACAGGGTTAAG	['AGAATA', 'GGTAAA', 'GTAAAA', 'TAAAAT', 'TGTATA']
AAAGATGAATAAATATGCCCATACTTCACGCATTACGTTAAGCATCCGTTATAATCGGTTGCAGATACCAGCCTGTGGATG	['ATAATC', 'ATACTT', 'CATACT', 'CGTTAA', 'TATAAT']
TGTCGATTACGGATAATGAACAGCATTGCTTATCAGAGATATGCCCCCATATGTTGAGGCATATCCTAACGAGAATCTGAC	['ATAATG', 'ATCCTA', 'GATAAT', 'GGATAA', 'TATCCT']
TTTATATTCCATTGCCGCTAATTGCCATGAATTAAAAATTCCAGTTAGCCATGATGCGGTCGATTGTTGCCGGAAAAGTGA	['AAAATT', 'CGCTAA', 'TAATTG', 'TATATT', 'TTAAAA']
TCTTAGAGTATAAAAGTTTTGTGCATTTGAAACATTACGCTTTGCAAAGGATTTTCATGGAACGTGCGAGTAAAATGCCGT	['AAAATG', 'AGTATA', 'GAGTAT', 'GTAAAA', 'TAAAAT', 'TACGCT', 'TAGAGT']
TCATAAAAATAATACTTCCAGACACTATGAAGTTGTGAAACATAATGTTAACTTCTCCATACTTTGGATAAGGAAATACAG	['ACACTA', 'ACTATG', 'ATAATG', 'ATACTT', 'ATGTTA', 'CATAAT', 'CATACT', 'GACACT', 'GGATAA']
GTTCGGGTGCCCCGTCGCTAAAAACTGGACGCCCGGCGTGAGTCATGCTAACTTAGTGTTGACTTCGTATTAAACATACCT	['ATGCTA', 'CGCTAA', 'CTAAAA', 'GCTAAA', 'TTAAAC']
GGGCCTTTTTTAGCGCGAGAGCCTTTTTTGTCAGCTATCTATACTTTAAGGTGACTGCCAAAACAGACTCGACGTAGCCTT	['ATACTT', 'CTATAC', 'TAAGGT', 'TAGCCT', 'TCTATA']
CAGAGGGATGGGTGATTTATTCAGTTGCCAAACCCGCTGGAGTATTGAGATAATTTTCAGTCTGACTCTCGCAATATCTTA	['AGATAA', 'ATAATT', 'GAGTAT', 'GATAAT']
AACCGAGGTCACAACATAGTAAAAGCGCTATTGGTAATGGTACAATCGCGCGTTTACACTTATTCAGAACGATTTTTTTCA	['ACAATC', 'ACACTT', 'ATGGTA', 'GTAAAA', 'TACAAT', 'TACACT']
TTAAAAACTTCATGGTAGTCGCATTTATAACCCTATGAAAATGACGTCTATCTATACCCCCCTATATTTTATTCATCATAC	['AAAATG', 'AAACTT', 'ATGGTA', 'CCTATA', 'CTATAC', 'TATATT', 'TCTATA', 'TTAAAA']
ACATGCTAACATATCCAAATAAGATCGATAACGATAATTAATTTCATTATCATGGAAGTTCGTATGTCTGGTTCTGTTGCC	['ATAATT', 'ATGCTA', 'CGATAA', 'GATAAT', 'TAACAT', 'TATCAT']
TGGCATTCACAAATGCGCAGGGGTAAAACGTTTCCTGTAGCACCGTGAGTTATACTTTGTATAACTTAAGGAGGTGCAGAT	['ATACTT', 'GGTAAA', 'GTAAAA', 'TGTATA']
GACTGGTAAGTTTTCAGATAGCGCCTCTCTTAATGCCGCTGCGATCGGGTATACTCGGGCGGCAATCTGGGATTTCCGGGG	['ATACTC', 'GGTATA', 'GTATAC', 'TAATGC']
TTTGCCCAATACATATATTGAGATTTAACTCATAATTACTTCCTAAAGTGTAATATTTTATTTTTTAATATATACGCCTAC	['ATAATT', 'ATATAC', 'CATAAT', 'CATATA', 'TATATT']
GCGTCACATTTAATCATAAATAATCTTGTTGTGATTACTTTTGAAAATTAGAGTGAGTGCACAACATTCCGGGTGTGTGGA	['AAAATT', 'ATAATC', 'TAATCT', 'TAGAGT']
TATTTTTAATTAAAATGGAAATTGTTTTTGATTTTGCATTTTAAATGAGTAGTCTTAGTTGTGCTGAACGAAAAGAGCACA	['AAAATG', 'TAAAAT', 'TAGTCT', 'TTAAAA']
ACTGTATAAATAAACAGTAATATTTGGACAAAACGCAAACTGTGATCGATACTCAACTATGCACTAAATACGTCAAAATTC	['AAAATT', 'ACTATG', 'ATACTC', 'GATACT', 'TGTATA']
TTCGTCATGGTTCGCTTCAGATCGTTGACAGCCGCACTCCATGACGGGTAAAAAGTGGATAAAATAATTTTACCCACCGGA	['ATAATT', 'GGATAA', 'GGTAAA', 'GTAAAA', 'TAAAAT']
CCTGACTACTGTATGTTACTTTATCCTGAACTACGCACCATTGAAGGTGTCTTAAAAAGTAAGATGAGTGGGTTAGGCATG	['ATGTTA', 'CTTAAA', 'TATCCT', 'TTAAAA']
CGCCTACAGAAATCTTACAAGACGAACACGTTAAGCGTGTATACCTTGGGGAAGACTTCAGACTCTGATAGGGTAGAAGTT	['CGTTAA', 'GTATAC', 'TAGGGT', 'TGTATA']
ATACACTAAGGCTATAAATGATATAGTGGTTATAGTTAGCACCTTTTTTATTATTAAATCGTATTAGTCACCCGCCAGGTG	['ACACTA', 'ATAGTG', 'ATAGTT', 'CTATAA', 'TACACT', 'TATTAT']
TCATACCCTTCTATTGATATGGATTAATAATTCTTAACCCAAAATGGGTAGACTCCCTCTATTGTTAGCGCGCTAAATATT	['AAAATG', 'ATAATT', 'CGCTAA', 'GCTAAA', 'TAATTC', 'TAGACT']
CCGTGGTTTCAGCTACAAAATTCGCTTTCTCGTTAGCTGCGCTTTTATTAAACTCTGCGCGATTATTATTGGCGAAGAAAT	['AAAATT', 'TAAACT', 'TATTAT', 'TTAAAC']
CAGGGCTGGCAGGCTAATTCGGGCTTGCCAGCCTTTTTTTGTCTCGCTAAGTTAGATGGCGGATCGGGCTTGCCCTTATTA	['CGCTAA', 'GCTAAG', 'GGCTAA', 'GTTAGA', 'TAATTC']
AATCATAAATATGAAAAATAATTGTTGCATCACCCGCCAATGCGTGGCTTAATGCACATCAACGGTTTGACGTACAGACCA	['ATAATT', 'ATATGA', 'GCTTAA', 'TAATGC', 'TAATTG']
TAAAAAGACGCGGACTCATGTGAAATACTGGTTTTTAGTGCGCCAGATCTCTATAATCTCGCGCAACCTATTTTCCCCTCG	['ATAATC', 'ATACTG', 'CTATAA', 'TAATCT', 'TATAAT', 'TCTATA']
AATGCGCGGTCAGGCACATTAATACTCGCACTGGCTATTATGCAAAATTCGCCATCTTCAACTAAGGTGAACAAGTTTCAC	['AAAATT', 'ATACTC', 'TAAGGT', 'TATTAT']
GGATACCATTGCTGATATAGCCAGAAAATATAATGCTTCATCCTGGAAAGTCACATCGATGCGAATTGATAATAATTCAAC	['ATAATG', 'ATAATT', 'GATAAT', 'TAATGC', 'TAATTC', 'TACCAT', 'TATAAT']
CACGCTCCTAATTCTTTGACCGAGCTAGTTATGGCGCGGAGTATTAGTTACGCTTGACAGAGTGTAAAACAAAACATTTAA	['GAGTAT', 'GTAAAA', 'TAATTC', 'TACGCT']
TAAAACAATGTGTTATGATAAAACATATTGCATCATTTAACTGACAATCTATACAAGATTTTTCGCCAACTAGTGTTCAAC	['ACAATC', 'ACAATG', 'CTATAC', 'GACAAT', 'TATGAT', 'TCTATA', 'TTATGA']
TTTCCAGAGTATCGTTATTACAATTAAATACCTTTAAATATCAACAAGTTAAAGTATAAAAATCAGCATAAACCCTGATTT	['ACAATT', 'AGTATA', 'GAGTAT', 'GTTAAA', 'TACAAT', 'TATCGT']
AGTTTGCGTTTTGTCCAAATATTACTGTTTATTTATACAGTAAACTTCTATAATATCACTGTACGCAATGTGTTATGCGGG	['AAACTT', 'CTATAA', 'TAAACT', 'TATAAT', 'TCTATA']
TAGATAGGGCGTTAATCTCCCATACTTAACCTGGTTTATGGTAAATTGCCCTCCATTTTGTTTAATTTGTAGATGATACGT	['ATACTT', 'ATGGTA', 'CATACT', 'CGTTAA', 'GGTAAA', 'TAACCT', 'TAATCT']
CTAACTAAATTCATGGTTAAGGTTGCATAATGATATGCAACAAATGTATAATATTTCCTTTACAAAAAAAATAAACAAAAG	['ATAATG', 'CATAAT', 'TAAGGT', 'TATAAT', 'TGTATA']
ACTGTTTTTTTATCCAGTATAATTTGTTGGCATAATTAAGTACGACGAGTAAAATTACATACCTGCCCGCCCAACTCCTTC	['AAAATT', 'AGTATA', 'ATAATT', 'CATAAT', 'GTAAAA', 'TAAAAT', 'TATAAT']
GATAAGTTTTAATTTCAATGGTAGGTTTATTTCTTAGCTTTCGCTAGTAAACTGATAATCAGACAAAATGGTGACATGAGG	['AAAATG', 'ATAATC', 'ATGGTA', 'CGCTAG', 'GATAAT', 'TAAACT']
ATTTCATCAATGAAATGTAAAAATATATAAACTTGATGATTTAAGCATTTTCTTATACCCGTTCAGACGTTATTCTTATTT	['AAACTT', 'GTAAAA', 'TAAACT', 'TATTCT']
ATCTTTCTATATTCAAAAATTGAATGAGTAATTCATAAAAATTCTGATATTTATAGCAAAAGTGGCGAACCACCCTTAATG	['AAAATT', 'TAATTC', 'TATATT', 'TCTATA']
GCGATGCAAGGCTAGCTAAAGAGTGACACTTTATCCTTGTTTACCCCTTATACTTTTCGCTGATAACCCAGATACACAGGA	['ACACTT', 'ATACTT', 'GACACT', 'GCTAAA', 'GGCTAG', 'TATCCT']
TTACATTTTCGCGACCGCTTTGGCTGCTTTCAGGTCCGTTTCAATGATATACTGCCAGTCGTTAATTCAAAAATAGTTGAT	['ATACTG', 'ATAGTT', 'ATATAC', 'CGTTAA', 'TAATTC']
AATACGACTTCTGATTTGAACAGTTAAAAACGAAAAGTCTGATAAAAGCTATACTTAACGGATAGCTTTCGCGACATAGGA	['AAGCTA', 'ATACTT', 'CTATAC', 'GTTAAA', 'TTAAAA']
AATAGCGAGTTAACTTGAAGCAATTTATTTAAAAATGAATTATTAATTATTATCGTGTTGATAATGGTACGACAAGGCAAC	['AAAATG', 'ATAATG', 'ATGGTA', 'GATAAT', 'TATCGT', 'TATTAT', 'TTAAAA']
CTTATACACTTAAGGCATGGATGGATATTGCTTCTGATATTGTCCGGCTGGACAATGTTACCGATAACAGTTACCCGTAAC	['ACAATG', 'ACACTT', 'ATGTTA', 'CGATAA', 'GACAAT', 'TACACT']
GCAAATGACAATACCCGGAAAATCCTTCTGAACTCTTCACCTTAAGCAATATCAAAAAAAATGGTAATCCATAAGATCATT	['AAAATG', 'ACAATA', 'ATGGTA', 'GACAAT', 'TAATCC']
TTTTCAGAAATTGCGCGTAAATTTTTCGCACTTAAAGAATATTTATTAATCTAACGCAATATATTCGGTCGTAAAGGAATC	['AGAATA', 'CTTAAA', 'TAATCT', 'TATATT']
ACATTCATGATGATTATTGATTTGAAGATAATGTTTTACTACCAACGGTAAAAATCGGTCATTCCGCATGGTATTCACGAA	['AAGATA', 'AGATAA', 'ATAATG', 'ATGGTA', 'GATAAT', 'GGTAAA', 'GTAAAA']
TGCGTTTTCGCTAATAGTTGACAGATTTATCCGCTCCATCGCGGGCGGATAATCTCCCCTTCCCCAACTTTCTTCGTAACG	['ATAATC', 'ATAGTT', 'CGCTAA', 'GATAAT', 'GGATAA', 'TAATCT']
AAGTTAATTTGTGAGTGGTCGCACATATCCTGTTCATTTCATTTTGATACACTTCATGCCGTCAATGAGGTAATTAACGTA	['ACACTT', 'TAACGT', 'TACACT', 'TATCCT']
ATTGTTAACAAAATCGTCATACTCTTTTTTTACGTCTGTAAATTCCCTACAATCCTGCCCATTGTCTGCCAACAACTATGG	['ACAATC', 'ACTATG', 'ATACTC', 'CATACT', 'TACAAT']
TCATCATTCAAAACCCAGATGTAATTGTCATCAAAGGCGGGAATACTGTTAAGATTCATAGATTACCTCTCAGTGTGAAAC	['ATACTG', 'CTGTTA', 'TAATTG', 'TAGATT']
CAACGCTAAGGATTCTCTCTGGTTGAAAATACTTAGCTGTTATGTGCCTGTCTTTTCACCACTTCAGGCTCGGTGGTATGC	['ATACTT', 'CGCTAA', 'CTGTTA', 'GCTAAG']
AGATAAATTTCCTGTTTTTAAAGCAGAGTTCCTCATTTAACGTCATTAATAAAATGTTCTAAAACGCTGGACAGACAGAAA	['AAAATG', 'AGATAA', 'CTAAAA', 'TAAAAT', 'TAACGT', 'TCTAAA']
TTTCAGGCAATGTTTCACCGCGTTTCATTGCAACAATTATGAAACAAGACTAAACCCAATATTCGGTTTCTTAACTTTGCG	['ACAATT', 'AGACTA', 'CTAAAC', 'TTATGA']
TGTTTGCTTCATGAATGCTCCTTTGCATTTAGCAACTGACTGTAACAGCTAAAATTAGTCGCTTTTGGCGGTGAATGCTGA	['AAAATT', 'CTAAAA', 'GCTAAA', 'TAAAAT']
CGCGCCGTAATTCGCATGCTTTAGTTGTGTATACTCGATCCCGCCCGAAATGTTTTTGGGTAAATCTCCATTCATTCAATG	['ATACTC', 'GGTAAA', 'GTATAC', 'TAATTC', 'TGTATA']
AAAATAGCGTGCGCAAAAGTCGTTCTTTGCCTAAAATATCGCTATATATGACAATATATAGCGAATGAGGTGAACGATGAA	['ACAATA', 'ATATGA', 'CTAAAA', 'GACAAT', 'TAAAAT']
AAGAATCAGAACAATTCACTATATAACATTGCATGTAAAGCATATACACCTCATTATTTTGTCATTATTAAGTTATTAACA	['ACAATT', 'ATATAC', 'CATATA', 'TAACAT']
TTGTTACAAAGCATATTAAACAGCAGCTTAAGTATACAATTTATTCGGCGAAACATTATTGATTCTGTTGATATGATCACG	['ACAATT', 'AGTATA', 'ATATGA', 'GCTTAA', 'GTATAC', 'TACAAT', 'TATGAT', 'TTAAAC']
ATACATTTGTTTTAGCAATACAATTGCTGCACACTATTCTAAAAGCCGCATAATATCTTAGCAAGCTAATTATAAGGAGAT	['AAGCTA', 'ACAATT', 'ACACTA', 'CACACT', 'CATAAT', 'CTAAAA', 'TACAAT', 'TATTCT', 'TCTAAA']
CCATTGCTTATATTGGCTGGTTACAATATGCACTATCAATTTTTTAAATAACAAATTATTAAAACCACATCTGTATAAGGA	['ACAATA', 'TACAAT', 'TATATT', 'TGTATA', 'TTAAAA']
TTTAAGATTTTCCTGCTTTCAAGATATATAACGTCGGTTTATAAACAGACTATTATCATAGGTAGGCCAAATGAGGATAAC	['AAGATA', 'AGACTA', 'GACTAT', 'GGATAA', 'TAACGT', 'TATCAT', 'TATTAT']
TTGCTGGAAGTTACCCGCAAAAATCTTGGTATGACTGTCATTTGCGATGACAATATGATGATTGAAGGCATCTTTACCGAC	['ACAATA', 'ATATGA', 'GACAAT', 'TATGAT']
TTGCTACTTCCTTCCCTGACTATTGATGATCTGAATGAATTGTCGCGGTAAAATAGCCCCGCCAGGGGTTTCCGGCATGAC	['GACTAT', 'GGTAAA', 'GTAAAA', 'TAAAAT']
GATGAGTGGTTATCACAACGCTGTAAACTTATTTGAGGGTGTTACATGAATTCATACTCAATTGCTGTCATCGGAGTGTAA	['AAACTT', 'ATACTC', 'CATACT', 'TAAACT']
AAATTTGAACATACCGGGCAGAATATCTGGCTAACAATGTAGCGTCCAGCCCCTTACCATAAAAGGAAGTAAAGAGAGGTC	['ACAATG', 'AGAATA', 'GGCTAA', 'TACCAT']
CGCACATCATTGCGCGATCCACCGTGAAACAGCTGCGTAAAAACGTACTGGCTAAATGTTATGGCGGCGATATCAGCCGTA	['ATGTTA', 'GCTAAA', 'GGCTAA', 'GTAAAA']
AGCAATCGAGCGGCAGCGTACTTACCCCGCACTCCATTAGCGGGTATACTCATGCCGCATTGTCCTCTTAGTTAAATGGAT	['ATACTC', 'GGTATA', 'GTATAC', 'GTTAAA']
GAGCTGAAAAACTGACGAATTATGATAAACTCCAGCCAACTTTATTTCATATCATTGAGGGCCTGTGGCTGATGGCACAGC	['TAAACT', 'TATCAT', 'TATGAT', 'TTATGA']
TTAATAAACGGATGTTTTTACATAATTAACTGAAATATATATGTTAATTTTATAATAATGGTTTATTAAGTTTGTTCAGAA	['ATAATG', 'ATAATT', 'ATGTTA', 'CATAAT', 'TATAAT']
CAACCAGTTGAAATATATAAATCTTGATTTCCTGACTTATCTTCCATCTATCAAAAGTTTAAGACTGGACAATAATAAAAT	['ACAATA', 'AGACTG', 'GACAAT', 'TAAAAT']
GTAAGCACTTTTAGGAATAGCCGCCGTTCAAAAATGTGTCACTGGTTTACACTTATTCAGGAATGCACAATGAACGGAGGT	['AAAATG', 'ACAATG', 'ACACTT', 'CACAAT', 'TACACT', 'TTAGGA']
GCAGAAATCACGCTCTGGATGAACGATGTGCTAAGATGCGGAGACTTAAGGTCAAAAAAACAGAAGGGTAAAAAATGGAAT	['AAAATG', 'GCTAAG', 'GGTAAA', 'GTAAAA', 'TAAGGT']
GGGCGTTTTGCTGTTAAATCAATAGATTATTTTTGGCATGATTCTTGTAATGCCAGCAAGAGATTTCATATTTGGGAGAGC	['CTGTTA', 'GTTAAA', 'TAATGC', 'TAGATT']
CATTCGTTAAGTCATATATGTTTTTGACTTATCCGCTTCGAAGAGAGACACTACCTGCAACAATCAGGAGCGCAATATGTC	['ACAATC', 'ACACTA', 'CATATA', 'CGTTAA', 'GACACT']
GAAGTCAACCTGTTGCTGCAAAAAGCAGCACAAGGTGCATTTCATGGTATAGTTGACTATACGGAATTGCCGTTGGTCTCT	['ATAGTT', 'ATGGTA', 'CTATAC', 'GACTAT', 'GGTATA']
AGAATAAGGGTGTCTGTTAATCGCATTGACGCCAAAATAACTTAATGTCATACACTTCACACACTTTTATTAACTCAGCAT	['ACACTT', 'AGAATA', 'CACACT', 'CTGTTA', 'TACACT']
TTATTGTGACAATGGTTAATTGTGACATTGACCTGAATTACGCTTTCATAAAAACATATTAACCAAATAAATATTTTTAAT	['ACAATG', 'GACAAT', 'TAATTG', 'TACGCT']
GCAGGGCGGTTTTCACGATAAGACCTCAATGAAAATGATAATTGTTATGCTAAAGTAGCCACTCTGTAAGCTGACAACACT	['AAAATG', 'ATAATT', 'ATGCTA', 'CGATAA', 'GATAAT', 'GCTAAA', 'TAAGCT', 'TAATTG']
TTATCTACACTTAAGTTAATTCTGACAGGCGCAGGTGGCAATAGCATGCCACTATTGAGTAAAGCCAGTCAGGGGAGAGAA	['ACACTT', 'TAATTC', 'TACACT', 'TAGCAT']
CTCCCTTATAAGTCTGTGGTTACGTCAATAGAGAGCTTTGTCACAATTATCTGCAAAGTCATACGCCGTTAATTGCTTTCT	['ACAATT', 'CACAAT', 'CGTTAA', 'TAATTG']
TCCTTAAACTGATATACATTGCCGAACAATGTGGTCTTTAGTTTCATAAGTCGTTCCCTCAGGAAGAATCGATGATTGGCA	['ACAATG', 'ATATAC', 'CTTAAA', 'TAAACT', 'TTAAAC']
CCAGATGTTTACACATCCATAATTGGCGGTTACTGTATATTCCTCAAGCGCAAATTATTCATGCCGAAGTGAAGGACTTTC	['ATAATT', 'CATAAT', 'TAATTG', 'TATATT', 'TGTATA']
GACAATAAAGGCATATAACCCGCGCAGAATAACGTATAGCAAATTAAAAGTATAATTTTTATTTTGTATGTATTATCTTCG	['ACAATA', 'AGAATA', 'AGTATA', 'ATAATT', 'CATATA', 'GACAAT', 'TAACGT', 'TATAAT', 'TATTAT', 'TTAAAA']
GCCTTCGCACTATTCAACAGCAATGATAGGCGCTCACCTGACAACGCGGTAAACTAGTTATTCACGCTAACTATAATGGTT	['ATAATG', 'CGCTAA', 'CTATAA', 'GGTAAA', 'TAAACT', 'TATAAT']
ATATAGCCAATCATTCTTACTCCCTTTGAATTACCCGCCTCATCAGAGATAATGCTTAAGAAATTTGTCACACAAGGAAGC	['AGATAA', 'ATAATG', 'GATAAT', 'GCTTAA', 'TAATGC']
TTTGATATCGGCTTTATTAATTCATTTAATCAATATATTAGCACTGATTACAATTATACCTTTTTATTATTCTGTGTCATG	['ACAATT', 'TAATTC', 'TACAAT', 'TATATT', 'TATTAT', 'TATTCT']
GGCATAAGGTTACGACTAACTGGTTTAAAAATAAAATTGATTATATATTTATAATTAATCTTTATAAGTGGTAAGCGACTA	['AAAATT', 'ATAATT', 'TAAAAT', 'TAAGGT', 'TAATCT', 'TATAAT', 'TATATT', 'TTAAAA']
CTGTAGCGCATAATGATTTCCTTATAAGCGATCGCTCTGAAAGCGTTCTACGATAATAATGATATCCTTTCAATAATAGCG	['ATAATG', 'CATAAT', 'CGATAA', 'GATAAT', 'TACGAT', 'TATCCT']
ATGGGCGGCAATTGTAACGTTTTTTTGGGCTGGAGCACGTTTTCTCTGACGGTTACACTGATAAGAAATAATTTCGTGTGG	['ACACTG', 'ATAATT', 'TAACGT', 'TACACT']
CATGATTACATAGCGAAAGTGTGGATGGTAAAAATCTCATTTACACGCTAGTATCGGCATAACCACTAAACACTCTAGCCT	['ATGGTA', 'CGCTAG', 'CTAAAC', 'GGTAAA', 'GTAAAA', 'TAGCCT', 'TAGTAT']
GCTGAAATAATCTCGCGCAGGACTGTAAATAGATTAAATTTTGTGGAAATATAATAAGTGATCGCTTACACTACGCGACGA	['ACACTA', 'ATAATC', 'TAATCT', 'TACACT', 'TAGATT', 'TATAAT']
ACCAGACTTTCCAGTGACTGTTCTTTGGCAAGGGATTGCGAGACGCGGGCGATAATCTGATCTGACACGGAACAACTCCAG	['ATAATC', 'CGATAA', 'GATAAT', 'TAATCT']
TTTTCACATTAATCTGGTCAATAACCTTGAATAATTGAGGGATGACCTCATTTAATCTCCAGTAGCAACTTTGATCCGTTA	['ATAATT', 'TAACCT', 'TAATCT', 'TAATTG']
GCGGTTAGCGCCCTTTTCATCCCTGTCTGAAATTTCTCAAATTCTAAAAATCTCAACCAAACTTATCTGATAACACTAAAT	['AAACTT', 'ACACTA', 'CTAAAA', 'TCTAAA']
GTAAAGATGGGTAAAACTTCTGGGTGCCCTTACGCATTATCATTATGCTGCTTAATTAATTACATCTGTCATAGAGAGTGA	['AAACTT', 'GCTTAA', 'GGTAAA', 'GTAAAA', 'TATCAT']
GGTTGGGATATTACGGCATAGTTCTTCACACTCCCTTCACTTACCCCGCTTAAATTGGCGCTCAAAGGTAAGTAAAGGGAG	['ATAGTT', 'CACACT', 'CTTAAA', 'GCTTAA']
ATTTATCGTAATCGTTCTTTATTTGGTCAGTTGTCAACCTGATACTTCGCTACAATGGATACCCGTTAATCAAAGAGTTTT	['ACAATG', 'ATACTT', 'CGTTAA', 'GATACT', 'TACAAT', 'TATCGT']
AGGCATCAATCTTTACGATCTGTATAAAGACGGATTGTTGATGATGTGTTAAAATTGATGTAAACAAATTGTGAAGTGAAT	['AAAATT', 'GTTAAA', 'TAAAAT', 'TACGAT', 'TGTATA', 'TTAAAA']
TGCTCTCGTTTCCTAAGAGTTGTTGCATTTTGCTATATGTTACAATATAACATTACACATCATATACATTAACTCTGGAGG	['ACAATA', 'ATATAC', 'ATGTTA', 'CATATA', 'TAACAT', 'TACAAT']
TTTGCAGCTACTCTTAGACCGGAACAGATTAACATCATCAGCACAGCCTATACTTTTTTTAATGTGGAACGTCATTCTCTG	['ATACTT', 'CCTATA', 'CTATAC', 'TAACAT']
TATTATGCGCTCTTTGTAGACACAGTACCGGATGATGTTAAGAGGCTGTATACTGAAGCAGCAACCAGTGACTTTGCTGCG	['ATACTG', 'ATGTTA', 'GTATAC', 'TATTAT', 'TGTATA']
ATAATTCACGCGTTAAGGCTAGCGGAATTGATTATCTTTTCGTATAACGATAGAAATGAAACGTTGTTTTAATTAAGGAGT	['ATAATT', 'CGTTAA', 'GGCTAG', 'TAATTC']
AAAGCCGCAGCAAGGGACAATTTTTGCAGCGGCACAGCGTTCAGATAGTTATTTTGTTAAATGTATTAACATGCTGAGTTT	['ACAATT', 'ATAGTT', 'GACAAT', 'GTTAAA', 'TAACAT']
TTGCTGGCCCTATAATATTGCGCTAGCATTGCTTTCTGGTTGTATCAGCGATACTCAAAAATTCTTAATACAATACTCATT	['AAAATT', 'ACAATA', 'ATACTC', 'CCTATA', 'CGCTAG', 'CTATAA', 'GATACT', 'TACAAT', 'TAGCAT', 'TATAAT']
TTTTGACTAAAGTCAACGAAAAGAATATTGCCGCCTTGAAGAAAGGAGGTATAATCCGTCGATTTTTTTTGTGGCTGCCCC	['AGAATA', 'ATAATC', 'GGTATA', 'TAATCC', 'TATAAT']
GCCGACATTTATCGCTAATGACGTGATAAAAATGCCTGATGTTCCCCGCTATACTGAAGAATATCGCAAGCATCTTGTGGA	['AAAATG', 'AGAATA', 'ATACTG', 'CGCTAA', 'CTATAC']
TCTTAAATTGTTGCGTCCGGGATCAAGGCGTCCCGGACGATTCAGGAGTACAATAGGCAGATAAAGGCTTAAACGCTGTTC	['ACAATA', 'AGATAA', 'CTTAAA', 'GCTTAA', 'TACAAT', 'TTAAAC']
AATGTGGCCGCATTTAGGAGTACGATTTTGCCGTTAATCGTGCATACTGTGCGCTTTTTTGTGGGCCAAGGGACTAAGCAC	['ATACTG', 'CATACT', 'CGTTAA', 'CTAAGC', 'TACGAT', 'TTAGGA']
TCATGTTTCGCGCGGCGCTACGCAAACCCGAATCATCGGATTTAACGGTACACTGATATTGACGCTCATAATGTAAAAAGG	['ACACTG', 'ATAATG', 'CATAAT', 'GTAAAA', 'TACACT']
AACAACAGAGATAAAAATATCTAAGATATTCACCTTATTGCAAGATATTTAAAATGCTCTAGAGTTAAAAGTATGATGTAA	['AAAATG', 'AAGATA', 'AGATAA', 'GTTAAA', 'TAAAAT', 'TAGAGT', 'TATGAT', 'TTAAAA']
GTTTACAACAAGCTGTAAGAGCTTACTGAAAAAATTAACATCTCTTGCTAAGCTTATTAAAGGCTTATAACACCTTCAGGC	['AAAATT', 'CTAAGC', 'GCTAAG', 'TAACAT', 'TAAGCT']
TACAGACACGCTCATCACTATGACGTGTCTGTATATTAATAAGCTAACCCGCATTGAGTTAACCAATAACGGATTCCATAC	['AAGCTA', 'ACTATG', 'TAAGCT', 'TATATT', 'TGTATA']
GCATTCACGCGCGGTGAGTGAGGAAAAATACGTTTAAAACGATCGATTGCGCTACGAGTCGGGTAAACTGTAGGAAAATTA	['AAAATT', 'GGTAAA', 'TAAACT', 'TTAAAA']
ACAACCTCATACTCAAGAGTCAAAATTTGCGTAATTTTACTACAGCTGAATCGATAAAATAGCCTCTGAAGATCAAAATAT	['AAAATT', 'ATACTC', 'CATACT', 'CGATAA', 'TAAAAT', 'TAGCCT']
GCGGAAAGTGTAGAGAAACGCGAAAAAATGGCGCTGGCACGTAAACTTAATGCCTTAACCATGCCGCACCCGGACCGACGC	['AAAATG', 'AAACTT', 'TAAACT', 'TAATGC']
CCTAAAAAGCAATATAAATCAGAGAATTGAACAACGCATGTGGAAAAAGTTACACTGCGAATATTCGGCACATAATTGCTG	['ACACTG', 'ATAATT', 'CATAAT', 'CTAAAA', 'TAATTG', 'TACACT']
ATCCAGTAATCTTGTTTACACCTTCGCATTATTTATCTCTTTTCGTTTCTATACTGATTTTTCTTAATCCGTTTTATTACA	['ATACTG', 'CTATAC', 'TAATCC', 'TAATCT', 'TCTATA']
AAACAATAAAAATCGTAGCTTCCTGTTGTCATTAGGTTATTTTACCTGTATAAATAACCAGTATATTCAACAGGGGGCTAT	['ACAATA', 'AGTATA', 'TATATT', 'TGTATA']
CACGAAAAAGAGAAAAAGGGTATACTCACGCACCCTTTTCAGGGGCAATGTCGAAATTTTATCATTCAGGAGGGCCGATGA	['ATACTC', 'GGTATA', 'GTATAC', 'TATCAT']
ACGGCTTTGTTGTTTTTGAAATTTATTAATTTAAACAATTAGTTGAGATATATCGTTGGCGTCACAAAAGCAAAATAACGT	['ACAATT', 'TAACGT', 'TATCGT', 'TTAAAC']
GCCAGGATCAGAATCATCATGCGTGCGCGCAGGCTGTAGTTGGTCATGGAGTTCCGTTATGGGACAATTAAGGTCACACTG	['ACAATT', 'ACACTG', 'CACACT', 'GACAAT', 'TAAGGT']
AACATCGCATTTTTTTGACACTAGAATTGCAGCAATATGGCGACGCCATTACATTGTGCTTCTCAAAAAGCTTAAACGTTG	['ACACTA', 'CTAGAA', 'CTTAAA', 'GACACT', 'GCTTAA', 'TTAAAC']
TGAGTGATGTTTTTATTTTATCTGTTTGTTTTGTAAGGGTAAATTAACTAAAATGGCACCATCAACAAAACCGGAAGAGGT	['AAAATG', 'CTAAAA', 'GGTAAA', 'TAAAAT']
TGCATTGAACTTGTGGATAAAATCACGGTCTGATAAAACAGTGAATGATAACCTCGTTGCTCTTAAGCTCTGGCACAGTTG	['GGATAA', 'TAAAAT', 'TAACCT', 'TAAGCT']
TTTATCCGGTGTTCCGTGAACTGTTTCATAAACAAAATGCAACAGCTAAAGGCTAAAACTATCAGCCAGGTCATTATCGCC	['AAAATG', 'CTAAAA', 'GCTAAA', 'GGCTAA']
TATCATATTAATAGAAATAAAGACATTGACGCATCCCGCCCGGCTAACTATGAATTAGATGAAGTAAAATTTATTAATAGT	['AAAATT', 'ACTATG', 'GGCTAA', 'GTAAAA', 'TAAAAT', 'TATCAT']
GAAAATAATTAAACTTAATCTCGTTTAACCTTTATTGATATGTACTACGTATCTTATTTACTTCCGGTTTACTAAGGAAAC	['AAACTT', 'ATAATT', 'TAAACT', 'TAACCT', 'TAATCT', 'TTAAAC']
TGACGAAAGCTAGCATTTAGATACGATGATTTCATCAAACTGTTAACGTGCTACAATTGAACTTGATATATGTCAACGAAG	['AAGCTA', 'ACAATT', 'CTGTTA', 'TAACGT', 'TACAAT', 'TACGAT', 'TAGCAT']
ATACTAAACAAAACTGCCAATACCCCTACATTTAACGCTTATGCCACATATTATTAACATCCTACAAGGAGAACAAAAGCA	['ATCCTA', 'CTAAAC', 'TAACAT', 'TATTAT']
GTCGTTTGCTTGAACGCGACGCCTGATTTGATACTCCCCCCTGACTCCTTCATACTGAAAGTGAACTGACAGCCAAATGGA	['ATACTC', 'ATACTG', 'CATACT', 'GATACT']
TCTTTAGACCAAATATTAGACATTATCTGAACGTATCATCTACAAATTAAACAAAATGGAGGGCAATTTACCATAAACCAG	['AAAATG', 'TACCAT', 'TATCAT', 'TTAAAC']
TACAATCGTGCGCTTGCCTATTCCTGTACCAAATGTATTACCGGGTATATTATCCATTGTGTTTATGTATGTCGGATATCT	['ACAATC', 'GGTATA', 'TACAAT', 'TATATT', 'TATTAT']
ATTCACACTCTTTACAGGAACTTTTTAGAGCAATAGGCCATCAGGAGTATAGTGATGCTCGACAGAAGAAGTGTTCTGAAT	['AGTATA', 'ATAGTG', 'CACACT', 'GAGTAT']
TAGACCACCAGCCAGATCCCGCTTCGGAGACTATTCTGGAAACGGTGTTATGAAATACACGCAAAGCGGGACGTACAGGGG	['AGACTA', 'GACTAT', 'TATTCT', 'TTATGA']
ACCCACTAATCGTCCGATTAAAAACCCTGCAGAAACGGATAATCATGCCGATAACTCATATAACGCAGGGCTGTTTATCGT	['ATAATC', 'CATATA', 'CGATAA', 'GATAAT', 'GGATAA', 'TATCGT', 'TTAAAA']
ATCACATTTTTATCGTAATTGCCCTTTAAAATTCGGGGCGCCGACCCCATGTGGTCTCAAGCCCAAAGGAAGAGTGAGGCG	['AAAATT', 'TAAAAT', 'TAATTG', 'TATCGT', 'TTAAAA']
GCGGACGCAAAACGTACCAGGAGGGTGTTTATATTGATGATATTATGTCGCCCTATAACTATACATGATGTCAATAAGAGA	['CCTATA', 'CTATAA', 'CTATAC', 'TATATT', 'TATTAT']
CCGTACCCATAACACAGGGACTAGCTGATAATCCGTCCATAAGGTTACAATCGGTACAGCAGGTTTTTTCAATTTTATCCA	['ACAATC', 'ATAATC', 'GATAAT', 'TAAGGT', 'TAATCC', 'TACAAT']
GCGGGAAATTCGATAAATAGCACATATGATTAAAACTCAGACCCAAGTGGTCGGATCACCTGCATATCATAAGAAGGAAAC	['ATATGA', 'CGATAA', 'TATCAT', 'TATGAT', 'TTAAAA']
ATTAGTACGTAAAATCGGTAACGGCTGGAAATCATTCAATACTCACACTATCGAAAGTTCCCCAGCCAACCGCGGTACGTT	['ACACTA', 'ATACTC', 'CACACT', 'GTAAAA', 'TAAAAT']
GAGTGCAACCTGATGAAAAATAGTGTCGCTGAGCACTAAAATTTAATGTAAATGGTGTGTTAAATCGATTGTGAATAACCA	['AAAATT', 'ATAGTG', 'CTAAAA', 'GTTAAA', 'TAAAAT']
ACACTTTCATTGTTTTACCGTTGCTCTGATTAATTGACGCTAAAGTCAGTAAAGTTAATCTCGTCAACACGGCACGCTACT	['ACACTT', 'CGCTAA', 'GCTAAA', 'TAATCT', 'TAATTG']
TGCTTCGATAATCCCGATCTGACTTTCTCTGCCCGTATCTTAAGGTCTATGATTGATACTGGTATTGGCGGAACAGGCAAA	['ATAATC', 'ATACTG', 'CGATAA', 'GATAAT', 'GATACT', 'TAAGGT', 'TAATCC', 'TATGAT']
ACTGGCGTATTTGAAGACAATATAATTATTTCTGGATATTGTTGAGGCTCCCTAATATTTACTTTAAGGGCTATATTAGAA	['ACAATA', 'ATAATT', 'GACAAT', 'TATAAT', 'TATATT']
GTAACCTTTGTCATCGACCCGCCTCTTTTTTAATCGCTTCCCGCCTGTTACACTGGATAGATAACCAGCATTCGGAGTCAA	['ACACTG', 'AGATAA', 'CTGTTA', 'TAACCT', 'TACACT']
TGAAATAAAAATGCATTTTTCCGCTTGTCTTCCTGAGCCGACTCCCTATAATGCGCCTCCATCGACACGGCGGATGTGAAT	['AAAATG', 'ATAATG', 'CCTATA', 'CTATAA', 'TAATGC', 'TATAAT']
CTGAGCGCTTCTGTAAACTAATGCCTTTACGTGGGCGGTGATTTTGTCTACAATCTTACCCCCACGTATAATGCTTAATGC	['ACAATC', 'ATAATG', 'GCTTAA', 'TAAACT', 'TAATGC', 'TACAAT', 'TATAAT']
ATTGTTAATAAACTGTCAAAATAGCTATTCCAATATCATAAAAATCGGGTATGTTTTAGCAGAGTATGCTGCTAAAGCACG	['GAGTAT', 'GCTAAA', 'TAAACT', 'TATCAT']
CGCGATAAGTTTGAGCGAACAATGCCACAGGCGTATTGTTGTTGGGCTTATAATTTCTCCGGTAAGGAATACCATGTATAC	['ACAATG', 'ATAATT', 'CGATAA', 'GTATAC', 'TACCAT', 'TATAAT', 'TGTATA']
TTAATTTTTTCATCGTGAGCCCTTTTTTTGAACTATTATTAAAAAATGATGTCACTGCGCGATAAATATTCATCTAATCAA	['AAAATG', 'CGATAA', 'TATTAT', 'TTAAAA']
CCGGACTAGCGATATGCGCCGAGTTTTTTTAAGCTAGTGAGTACACGGCTGCAGAATTCCGCTACAATCTGCGCCACTATT	['AAGCTA', 'ACAATC', 'TAAGCT', 'TACAAT']
GTTTCGTTCTGATATGGATCAGAGTTGAAAAACATGTCTGATATAAAATTAAACATTGTTGATAATTGTTTATATTGGTTG	['AAAATT', 'ATAATT', 'GATAAT', 'TAAAAT', 'TAATTG', 'TATATT', 'TTAAAC']
CTCTGCTGTTAAGGTTTGCTTAGACTTACTTGCTCCCTAAAAAGATGTTAAAATTGACAAATATCAATTACGGCTTGAGCA	['AAAATT', 'ATGTTA', 'CTAAAA', 'CTGTTA', 'GTTAAA', 'TAAAAT', 'TAAGGT', 'TAGACT', 'TTAAAA']
TGGCAAATATTCTGAAATGAGCTGTTGACAATTAATCATCGAACTAGTTAACTAGTACGCAAGTTCACGTAAAAAGGGTAT	['ACAATT', 'GACAAT', 'GTAAAA', 'TATTCT']
AACCCTCTCCTTTAACCGGGCATAAGGTTACGACTAACTGGTTTAAAAATAAAATTGATTATATATTTATAATTAATCTTT	['AAAATT', 'ATAATT', 'TAAAAT', 'TAAGGT', 'TAATCT', 'TATAAT', 'TATATT', 'TTAAAA']
TTCTTTACCGAAAGTGGTTAAAGTGCAAATCGGCTCGGCGACCACAATATCAAAGCGGCTATACGGATGATCGGCATAGCC	['ACAATA', 'CACAAT', 'CTATAC', 'GTTAAA']
TTTCTCCGGTGCAAGATTCATATTTATATAGTAATATATAAAATTATATATAATTGGGCTGTTGCGATGACAAAATTACAA	['AAAATT', 'ATAATT', 'TAAAAT', 'TAATTG', 'TATAAT']
TTTTATTGAATGTAGAATTTTATTCTGAATGTGTGGGCTCTCTATTTTAGGATTAATTAAAAAAATAGAGAAATTGCTGTA	['TAGGAT', 'TATTCT', 'TTAAAA', 'TTAGGA']
TGTGTAAAATTTAGACTATCGTATGTTGATTATTGCGATGTTTCATCTTATCTTTTACACGTTTGCACCATATAATCGACT	['AAAATT', 'AGACTA', 'ATAATC', 'CATATA', 'GACTAT', 'GTAAAA', 'TAAAAT', 'TAGACT', 'TATAAT', 'TATCGT']
GCTGACGCAAATGCCGTCAGATGAGTAGACACTAAACAAAAATCGGGCAATACTGCGTGAGAATTTCCTCAAAGCAGGCAT	['ACACTA', 'ATACTG', 'CTAAAC', 'GACACT']
CGACCGCTAACGGAAGATACCTTGCGATTGCTGGAAAAAATCGCCCCTTCCGCACATAAAATTGGTGCATCGAGCGCGATT	['AAAATT', 'AAGATA', 'CGCTAA', 'TAAAAT']
GTTGCAGAAACCAAAGTGGCGATGGTGAACAAGTACGCGAGGGAGAATGAGCATCCATTGCTGTGTACGCTAGAAAAAGCC	['CGCTAG', 'CTAGAA', 'GCTAGA', 'TACGCT']
TTCACTAAAAAGTGTGATCGGGGACAATATATTTACGCACGTTATGTTTAAAGGCACTACACTGATTGGGGAATACTGAAA	['ACAATA', 'ACACTG', 'ATACTG', 'CTAAAA', 'GACAAT', 'TACACT', 'TATATT']
GTTTTGCGGTGCCCTGTACAATCCCCGTAAACATACTTACAACTCCTGAAATCAGTTAAGACATTCTGTTCAGCACAATAG	['ACAATA', 'ACAATC', 'ATACTT', 'CACAAT', 'CATACT', 'TACAAT']
AACCTGCCGTTAATGTCAACCTTGCGTAATGCACAATTACGTAAACAATTAAAATTATAAATACAGGAGTCCGGCGTGGAA	['AAAATT', 'ACAATT', 'CACAAT', 'CGTTAA', 'TAAAAT', 'TAATGC', 'TTAAAA']
CATCATCCTTTAGGCATTTGCACAATGCCGTACGTTACGTACTTCCTTATGCTAAGCCGTGCATAACGGAGGACTTATGGC	['ACAATG', 'ATGCTA', 'CACAAT', 'CTAAGC', 'GCTAAG']
GAAAGCTAAGAAATAAACCTACCATTGAAATTAAAACTTATCAGATTTAGCATGTGAATCAATTTAGAAGGTCACAAGACG	['AAACTT', 'AAGCTA', 'GCTAAG', 'TACCAT', 'TAGCAT', 'TTAAAA']
ATTACACTGATGTGATTTGCTTCACATCTTTTTACGTCGTACTCACCTATCTTAATTCACAATAAAAAATAACCATATTGG	['ACAATA', 'ACACTG', 'CACAAT', 'TAATTC', 'TACACT']
TAATTCCCGCCAAATAGCTTTTTATCACGCAAATAATTTGTGGTGATCTACACTGATACTCTGTTGCATTATTCGCCTGAA	['ACACTG', 'ATAATT', 'ATACTC', 'GATACT', 'TAATTC', 'TACACT']
AGGCAGACTACTCGCCGATTGTCATAAGGTAAAAGTCTCATTTATGATGAGTTCCATTGGATTTACTTATAGGTTGCGAAT	['AGACTA', 'GGTAAA', 'GTAAAA', 'TAAGGT', 'TATGAT', 'TTATGA']
AAGCCCTGCTTTTTCCCGTTTCGTACTGTATATCTTCCATCCAGCGGGTATACTGATCCCTTCCTTTAAATCCACACGTAT	['ATACTG', 'GGTATA', 'GTATAC', 'TGTATA']
GACCTTTGTTACAATTAGATTCAATTTGAATTTATGTTTTTGAATGCTTTCTTATCTCACGATTTAACAGGGAATAGTTCA	['ACAATT', 'ATAGTT', 'TACAAT', 'TAGATT']
AATTGATTGAATGAATATACAGGGAATAATAATTTCTATTTTATATTATTCCCTGTTTTAATTAACTCTATCAGGGATGGT	['ATAATT', 'ATATAC', 'TATATT', 'TATTAT']
ACTGTCAGTTACAAAATCCACAGCGTTGAGATTTTTCCAGGGGCGGCGCACAATAGCGTCACCCACTGACAATCCGTAAAG	['ACAATA', 'ACAATC', 'CACAAT', 'GACAAT']
CGTTGCGGTTCAGACATGTGAGGCACTCGGTTATGAATTACCGCGATGCTACAATGTGGCGCGAAGAATGTTAACCCTCTG	['ACAATG', 'ATGCTA', 'ATGTTA', 'TACAAT', 'TTATGA']
GTGCCATGTCCTCTCCCGCGTGAGAAATACGCTTCCCCGTAAGCGCATGGTAAACTATGCCTTCAAATCGGGCTTATCGCG	['ACTATG', 'ATGGTA', 'GGTAAA', 'TAAACT', 'TACGCT']
AAATGGATACTTTGTCATACTTTCGCTGCAATAACATCTCTGCGAGACGGCTTAACATGCCTGTTGTAAACTGTGAGCCAA	['ATACTT', 'CATACT', 'GATACT', 'GCTTAA', 'TAAACT', 'TAACAT']
TGGGGGTACAATTGTGATTGCTTTTGCATGAACATTGCGCCTTTATGCATAATGAGATAAAGGAATATCAAATAAAATAAC	['ACAATT', 'AGATAA', 'ATAATG', 'CATAAT', 'TAAAAT', 'TACAAT']
GCGAGAGCAACATTGCTGTAGATTGATATTTAATATATTAGCGTAACTGTTATGCTGTTATCTATATTATGTGATCTAAAT	['CTGTTA', 'TAGATT', 'TATATT', 'TATTAT', 'TCTAAA', 'TCTATA']
CAAAGCTGAATCGATTTTATGATTTGGTTCAATTCTTCCTTTAGCGGCATAATGTTTAATGACGTACGAAACGTCAGCGGT	['ATAATG', 'CATAAT', 'TATGAT', 'TTATGA']
CGAAGTAATGATTTTTCGCGCCCTTTGGCTAACACTAAACGTACACTCATAATTTACTTTTCTGTCGATGCAAAGAAATGG	['ACACTA', 'ATAATT', 'CATAAT', 'CTAAAC', 'GGCTAA', 'TACACT']
CATCGACATTATTCACCGCAGGGATAATCAACACTGGCACAATTATTGCTTGTAGCTGGCAATAGTTAATGGGAGGCGATA	['ACAATT', 'ACACTG', 'ATAATC', 'ATAGTT', 'CACAAT', 'GATAAT', 'GGATAA']
AACCTGAAGGTGGCGATCCCGCACTTTGTCAGGCTGCGTTGGCAGCAGCTAAACTTGCGAAGATCCCGAAACCACCAAGCC	['AAACTT', 'CTAAAC', 'GCTAAA', 'TAAACT']
TTCCTCAACATCATCCTCGCACCAGTCGACGACGGTTTACGCTTTACGTATAGTGGCGACAATTTTTTTTATCGGGAAATC	['ACAATT', 'ATAGTG', 'GACAAT', 'TACGCT']
CCTAAAAACAATGCTGGCATACGTGTTGAAGACATGATGATATCCTTAACTAAAGGTGTCATTTTGATATCCTCACAATAC	['ACAATA', 'ACAATG', 'CACAAT', 'CTAAAA', 'TATCCT']
TTAATGTAAATGGTGTGTTAAATCGATTGTGAATAACCAGCGCTTCCGGCAGGATACGGTCGCCCTGGTAAAACATAAACT	['GGTAAA', 'GTAAAA', 'GTTAAA', 'TAAACT']
CGTAACGTGGCGTAAACGGCAATGACTGGTTAGCATAAATCTATTACGCGGCATGACGCTGCATTGATGTATTTACACTTA	['ACACTT', 'TAACGT', 'TACACT', 'TAGCAT']
ATCCCAATCGTTCTTCTATACGACGCACTATCTGGCTTAAAGCTGACTGCGCCATGCTCAGGCGGGCTGCTGCACGAGTGA	['CTATAC', 'CTTAAA', 'GCTTAA', 'TCTATA']
GATTTACTGGCGCGACTGGGTTTTGAAAAAGAAGGCTATGCGAAAGACTATCTGTTGATTGATGGACAATGGCGCGATCAC	['ACAATG', 'AGACTA', 'GACAAT', 'GACTAT']
TTATTTATAGAGTAAAAACAATCAGATAAAAAACTGGCACGCAATCTGCAATTAGCAAGACATCTTTTTAGAACACGCTGA	['ACAATC', 'AGATAA', 'GTAAAA', 'TAGAGT']
TCTTACTCATGCTTCCTCCGCGTTGTTGCATTGGATGAGGCGAATTTCCCACAATCGGGGATAATTACCTCATGGTCTATT	['ACAATC', 'ATAATT', 'CACAAT', 'GATAAT', 'GGATAA']
ATAATTCATGCTTCATTATTACTCCGGAAAATGGAAGCGACGATTTTGGGTGGCTGGCCGTTAAAAATTTTAACTGCATTT	['AAAATG', 'AAAATT', 'ATAATT', 'CGTTAA', 'GTTAAA', 'TAATTC', 'TTAAAA']
CCCGTAATATCAGGGAATGACCCCACATAAAATGTGGCATAAAAGATGCATACTGTAGTCGAGAGCGCGTATGCGTGATTT	['AAAATG', 'ATACTG', 'CATACT', 'TAAAAT']
GTCATCTAATAAACGGTAAACATTCTTTTTATATTCACGGCATTACTGATAAAAAAGTCGCTCTCGCATAAAATTTACACT	['AAAATT', 'GGTAAA', 'TAAAAT', 'TACACT', 'TATATT']
AACCTGCAAACATTGTTAACTCCTGCTAAATTGTTGGCGCTAATTATTTCATGCTACCCGGCACATAGCCAGTAGAGTCAG	['ATGCTA', 'CGCTAA', 'GCTAAA', 'TAGAGT']
ATGATTATATTTTTATTTCGCATATAAAATCCTTTTAAATAAACTCAGGCACCAGACATAAAATATACTCTTTGTATAATC	['ATAATC', 'ATACTC', 'ATATAC', 'CATATA', 'TAAAAT', 'TAAACT', 'TATAAT', 'TATATT', 'TGTATA']
AAGGCGACAGAGTAATCTGTCGCCTTTTTTCTTTGCTTGCTTTCTGTTAGATTCCGCCGCAAATCTATACTGAATAAAACG	['ATACTG', 'CTATAC', 'CTGTTA', 'GTTAGA', 'TAATCT', 'TAGATT', 'TCTATA']
TAAGCTCTTGTCAGCGGCAGGGCGTTCTGCCGATAACCGTAACCGAAGATGATAACTGACAATGGGTAAAACGAACGACTG	['ACAATG', 'CGATAA', 'GACAAT', 'GGTAAA', 'GTAAAA', 'TAAGCT']
AACACCGTTTCCAGAATAGTCTCCGAAGCGGGATCTGGCTGGTGGTCTATAGTTAGAGAGTTTTTTGACCAAAACAGCGGC	['AGAATA', 'ATAGTT', 'GTTAGA', 'TAGTCT', 'TCTATA']
TGCCTTGCCATCAAATATTTTAAATACCTATTCTTAGGCTGCACATGCTAACATATCCAAATAAGATCGATAACGATAATT	['ATAATT', 'ATGCTA', 'CGATAA', 'GATAAT', 'TAACAT', 'TAGGCT', 'TATTCT']
CCTGGTGCACATTCGGGCATGTTTTGATTGTAGCCGAAAACACCCTTCCTATACTGAGCGCACAATAAAAAATCATTTACA	['ACAATA', 'ATACTG', 'CACAAT', 'CCTATA', 'CTATAC']
AAAAATGGCTGTTTTTGAAAAAAATTCTAAAGGTTGTTTTACGACAGACGATAACAGGGTTGACGGCGATTGAGCCGACGG	['AAAATG', 'AAAATT', 'CGATAA', 'TCTAAA']
TGCGCAAAAAGTGTGAGCAAGGGCTACGTCACATGGCCGCGCCGTGTATAATAAGCTCGTATGTAGGCTTTATTTCGCTAA	['CGCTAA', 'TAAGCT', 'TAGGCT', 'TATAAT', 'TGTATA']
TACTTTTCCTAATTAATCCCTCAGGAATCCTCACCTTAAGCTATGATTATCTAGGCTTAGGGTCACTCGTGAGCGCTTACA	['AAGCTA', 'CTAGGC', 'TAAGCT', 'TAATCC', 'TAGGCT', 'TAGGGT', 'TATGAT']
GTATCCCGGATCGTTTCTGAACAAACTTAATAAACCATTATTATAAAATTAACATATATATTTCAGTTAATTATGTAAAAA	['AAAATT', 'AAACTT', 'CATATA', 'GTAAAA', 'TAAAAT', 'TAACAT', 'TATATT', 'TATTAT']
ATATCGTTATTATCACTCCCTTTTACTGGCTAAACCAGAAAACTTATTTTATCATTCAAAAAATCAGGTCGGATTGACGCC	['AAACTT', 'CTAAAC', 'GCTAAA', 'GGCTAA', 'TATCAT', 'TATCGT', 'TATTAT']
TCGGTAATTTTATATTCGTTATCATTAAAAACTAATACAGAAAAAATAAATATAATTTTGGTGAATGTTTTGACATGATTA	['ATAATT', 'TATAAT', 'TATATT', 'TATCAT', 'TTAAAA']
ACAGGCACTTAACATCAACACCAATAATAAACTGGCAAACCGGTAAATAACGCTATTACGTTTCCTGCTAACCATAGTGTA	['ATAGTG', 'GGTAAA', 'TAAACT', 'TAACAT']
TGCCGCTGTTAAGTGCGGTGATGGTAAAAGAAACCTGCACCGCAGGTTGTATCTATCGCGGCGAATGATAAGAGTGTGTCG	['ATGGTA', 'CTGTTA', 'GGTAAA', 'GTAAAA']
TGAAACCAGTCATCAAATATTACCGTTTCACAACACTAATTTCACTCCCTACACTTTGCGGCGGTGTTTAATTGAGAGATT	['ACACTA', 'ACACTT', 'TAATTG', 'TACACT']
GGAGGCACACCAGATTCCTCTCATTTAAAATCGCCCCTCCTCCAGCATCTATACTTATCTTTTTGCTCTATTTTCTCACTG	['ATACTT', 'CTATAC', 'TAAAAT', 'TCTATA', 'TTAAAA']
ATAATTGCCTTAACTGCCTGACAATTCCAACATCAATGCACTGATAAAAGATCAGAATGGTCTAAGGCAGGTCTGAATGAA	['ACAATT', 'ATAATT', 'GACAAT', 'TAATTG']
CAGCAATGGGTAAAGTCTGGTTTATCGTTGGTTTAGTTGTCAGCAGGTATTATATCGCCATAGATGCTACGAATATTATTG	['ATGCTA', 'GGTAAA', 'TATCGT', 'TATTAT']
AACGATAAACCAGACTTTACCCATTGCTGAATGCACGGGTAACGTTAGGCTCAAATAATTAAACAACACGTTACAGGACAA	['ATAATT', 'CGATAA', 'TAACGT', 'TAGGCT', 'TTAAAC']
AGTCATTTTTCTGCAATTTTTCTATTGCGGCCTGCGGAGAACTCCCTATAATGCGCCTCCATCGACACGGCGGATGTGAAT	['ATAATG', 'CCTATA', 'CTATAA', 'TAATGC', 'TATAAT']
GGGTCATGCTGAAGCGAGACACCAGGAGACACAAAGCGAAAGCTATGCTAAAACAGTCAGGATGCTACAGTAATACATTGA	['AAGCTA', 'ATGCTA', 'CTAAAA', 'GCTAAA']
TGACAAATCATGCGGATATAAAATTTAACATTTGGATTGATAATTGTTATCGTTTGCATTATCGTTACGCCGCAATCAAAA	['AAAATT', 'ATAATT', 'GATAAT', 'TAAAAT', 'TAACAT', 'TAATTG', 'TATCGT']
CCGCTACAGATTGGTTAGCATATTCACCTTTAATCGCGCATGATCGAAAGATAATTAAAGAGGTTAATGTGTTCGCTGAAT	['AAGATA', 'AGATAA', 'ATAATT', 'GATAAT', 'TAGCAT']
TAGTTAACCTTGCTGCGACAATTTTTGATTTAAGGCAGTTAAAGTTGTATTGGTGGTAGCAGCAATTTCATATGGAATTGT	['ACAATT', 'GACAAT', 'GTTAAA', 'TAACCT']
AACAATCAGAACGGTTCTGTCTGCTTGCTTTTAATGCCATACCAAACGTACCATTGAGACACTTGTTTGCACAGAGGATGG	['ACAATC', 'ACACTT', 'GACACT', 'TAATGC', 'TACCAT']
AAATAACGCCACAATATTGCGATTAATTAACATGTCCGGTATTCCATTTTAAAATAAGATAAAAAAGAGTCGGCATAATAA	['AAGATA', 'ACAATA', 'AGATAA', 'CACAAT', 'CATAAT', 'TAAAAT', 'TAACAT', 'TTAAAA']
TTTTAAGACGGTATACAGAGCAGGAAAATCCATAACCGTAGCCGCATTTTTCATAGTGAGATGAAAGCGATTACAAACTTG	['AAACTT', 'ATAGTG', 'GGTATA', 'GTATAC']
CCCCATATAGAAATAATTTTAATGGTTAGTTGTTATTATTCATTGAAATATAATATAACTACCCGCGAAATATTATGAAAA	['ATAATT', 'CATATA', 'TATAAT', 'TATTAT', 'TTATGA']
GATATTGTGTTAGATATCCTTGTGGCAGGCGATTACCACTCTGCGATCCATAATCTCGAGATACTTAAAGCAGAACTCTTG	['ATAATC', 'ATACTT', 'CATAAT', 'CTTAAA', 'GATACT', 'GTTAGA', 'TAATCT', 'TATCCT']
CTTAACATTCATGTTATGATGCTCTTGAAACTAATAATACGTATGGAATTGTCACTATTTATCTGCTAATGAATTCAAACA	['ATGTTA', 'TAACAT', 'TATGAT', 'TTATGA']
GTACCAGCGAGCCGCGCGTCTGCCTCGATAAAGTTATCGAAACCATGTACGAAACAGGTAAAGATATGAACGCCAAGTACC	['AAGATA', 'ATATGA', 'CGATAA', 'GGTAAA']
TTTTTCACTTTACCTCCCCTCCCCGCTGGTTTATTTAATGTTTACCCCCATAACCACATAATCGCGTTACACTATTTTAAT	['ACACTA', 'ATAATC', 'CATAAT', 'TACACT']
AAAATCAAAGCCTAATCAATGTTTATGAACCTGCTTCGGCAGGTTTTTTTATACTTGACAATGTACCTTTGAGATACATAA	['ACAATG', 'ATACTT', 'GACAAT', 'TTATGA']
ACGAAGGATTTTAGCCGTCCAGATGTTTACACATCCATAATTGGCGGTTACTGTATATTCCTCAAGCGCAAATTATTCATG	['ATAATT', 'CATAAT', 'TAATTG', 'TATATT', 'TGTATA']
AACCGTGGTTGAGCGAGGTGGTCATAGTGTTGATTGCACCAGAGCCTGGCGACAGGCTTAAAATGATCGATGTCAGCAGGT	['AAAATG', 'ATAGTG', 'CTTAAA', 'GCTTAA', 'TAAAAT', 'TTAAAA']
AACATGGTTTGGTCAGCATAGCATCATGTTGTGCGGATAAACACCTGCTATTTTAATATTTGTTACAGTTGCTAAACACGC	['CTAAAC', 'GCTAAA', 'GGATAA', 'TAGCAT']
GATTCGCGTTAATGCTGCATTCATTTGCCGCAGTGGCGTTAATTGTGGTTATCATGGTGCATATCTACGCCGCCCTTTGGG	['CGTTAA', 'TAATGC', 'TAATTG', 'TATCAT']
ATGTATAACATTATGGCGTTTATCTGCCGCTTCGACGTAAACTGTGCGGTAAATTTGCCCACTTGTTTGTAAAGAAAGAGA	['GGTAAA', 'TAAACT', 'TAACAT', 'TGTATA']
CTGGTAAAAGAAACACTGATGCGAGGCCTGTGTTTCAATCTTTAAATCAGTAAACTTCATACGCTTGACGGAAAAACCAGG	['AAACTT', 'ACACTG', 'GGTAAA', 'GTAAAA', 'TAAACT', 'TACGCT']
GCCTGTGGGCCGCCGCTGATGGGTAAAATACACGATGCTAACGGTAACTGGTCTGTACCACTTATGGGTGTTGCCATACTT	['ATACTT', 'ATGCTA', 'CATACT', 'GGTAAA', 'GTAAAA', 'TAAAAT']
TGGCGCAAAACACGCTGATTTTTTCATCGCTCAAGGCGGGCCGTGTAACGTATAATGCGGCTTTGTTTAATCATCATCTAC	['ATAATG', 'TAACGT', 'TAATGC', 'TATAAT']
ACCTCAATGAAAATGATAATTGTTATGCTAAAGTAGCCACTCTGTAAGCTGACAACACTCAATATGCAACGAATCATTTTA	['AAAATG', 'ATAATT', 'ATGCTA', 'GATAAT', 'GCTAAA', 'TAAGCT', 'TAATTG']
TCGATCCTTGAGGGATGATTGCATTACATACAGATATAGCACAGGCTATATTATATAGCTATTGCTAAAACGTTAATTTTT	['CGTTAA', 'CTAAAA', 'GCTAAA', 'TATATT', 'TATTAT']
TCACTCTAAAATGTTTTTTCAATGTTACCTAAAGCGCGATTCTTTGCTAATATGTTCGATAACGAACATTTATGAGCTTTA	['AAAATG', 'ATGTTA', 'CGATAA', 'CTAAAA', 'TAAAAT', 'TCTAAA', 'TTATGA']
AACAATGTTGAAAATGCCAGCCAACTGCATGAAGTATGGCAAAAAGGGGCTGATGAAAATGCCAGCACAATACGATTAAAT	['AAAATG', 'ACAATA', 'ACAATG', 'CACAAT', 'TACGAT']
CAAGAAAATTCGTTGGATATTTTTTTTGCATGGATAAAATTATCGCCTCTAAAGTATGTAATAACAGGGAATGTGATGAAA	['AAAATT', 'GGATAA', 'TAAAAT', 'TCTAAA']
TTTTTGCTTAAGAAATCGTGAGTTAAGGTTGAAAGAGCAGGTTTAACTCGACCATACTCTATACTCGCAGTGTGGCGCGGC	['ATACTC', 'CATACT', 'CTATAC', 'GCTTAA', 'TAAGGT', 'TCTATA']
CATCTAAACTTCTTTGCGTATAGATTGAGCAAATCCCAAATAGCCGTTAAAATTATATGCATTATCACGCCGACAGGTGCA	['AAAATT', 'AAACTT', 'CGTTAA', 'CTAAAC', 'GTTAAA', 'TAAAAT', 'TAAACT', 'TAGATT', 'TCTAAA', 'TTAAAA']
AATAGCCTAATAATCCAGACGATTACCCGTAATATGTTTAATCAGGGCTATACTTAGCACACTTCCACTGTGTGTGACTGT	['ACACTT', 'ATAATC', 'ATACTT', 'CACACT', 'CTATAC', 'TAATCC', 'TAGCCT']
CGGAGTCTCTCCCTTTTAATTTTTCACTTCTAAAAGCAGTATGATGTCATAAAGTTAAGTGAGAATAATTAAGGGATGACT	['AGAATA', 'ATAATT', 'CTAAAA', 'TATGAT', 'TCTAAA']
GGGTTATTTTGTTTGATATATATCAATTGGTACTTTCATATGACACTTAGAATCAATGCTCTCTATAGTGATGAATAATCA	['ACACTT', 'ATAATC', 'ATAGTG', 'ATATGA', 'GACACT', 'TCTATA']
TGCCTGTATAATCTTTAAAGATGTTGAACATATATTCACATTAAATATGATTATGTACTTGTTACAAGGATAAGGTTATAT	['ATAATC', 'ATATGA', 'CATATA', 'GGATAA', 'TAAGGT', 'TAATCT', 'TATAAT', 'TATATT', 'TATGAT', 'TGTATA']
GAAAGTTAAATTACGGATCTTCATCACATAAAATAATTTTTTCGATATCTAAAATAAATCGCGAAACGCAGGGGTTTTTGG	['ATAATT', 'CTAAAA', 'GTTAAA', 'TAAAAT', 'TCTAAA']
TTAATACACCTACTTTGAGCCGGTTCACACTTTTCAATGAAAATTGCTGATCAATTTCATGATGAGTTATGTAGACTGGCC	['AAAATT', 'ACACTT', 'AGACTG', 'CACACT', 'TAGACT']
AAGCTCTGTTGTTAAAGGGTTGCGCAACATACCGCGCAAATGATACTGATCATAAGCGTTAAAAAAATCTACAAACCAACG	['ATACTG', 'CGTTAA', 'GATACT', 'GTTAAA', 'TTAAAA']
GTGAGTACAGTGACTTCATAAAAATTATGAGATTTTTCACGGTGCTGTAAAATCCCTACCCTTACCGATGTAAAGCGACTA	['AAAATT', 'GTAAAA', 'TAAAAT', 'TTATGA']
GCATTGCGAGGCTCGTTTATTTATACTTTTCTGACGCGACATAATACGCATAAAATAAGGCTTACGCAAAAATGGAACACA	['AAAATG', 'ATACTT', 'CATAAT', 'TAAAAT']
CAGGGATATCAATGAGCTATTTTTGATAGTTCTTGCGGTTAATATGCTCTATATAGTGATGTTCCGATGACTTATGACTAT	['ATAGTG', 'ATAGTT', 'GACTAT', 'TCTATA', 'TTATGA']
TGCGTACCGCTTGCGAACCCGCCAGCGTTTCGAATATTATCTTATCTTTATAATAATCATTCTCGTTTACGTTATCATTCA	['ATAATC', 'TATAAT', 'TATCAT', 'TATTAT']
ATTTCTGCTGGTTTGCTCTCTCATTAGAATTTAACACTAAAAGAGCAGGTAAAATTGTCTGAATGTTCTTTAAGTTATTCA	['AAAATT', 'ACACTA', 'CTAAAA', 'GGTAAA', 'GTAAAA', 'TAAAAT']
GTTGAAAATAAACCTTCGATTTGTTTGTCAAGATATTGTCCATCTTTATATAATTTGGGGGTAGGGTGTTCTTTATGTAAA	['AAGATA', 'ATAATT', 'TAGGGT', 'TATAAT']
GGGTGATTGTAACGGGCATAGGTTAAATAAAACTTAAAGAAAGCGTAGCTATACTCGTAATAATGTAAGAATGTGCTTAAC	['AAACTT', 'ATAATG', 'ATACTC', 'CTATAC', 'CTTAAA', 'GCTTAA', 'GTTAAA']
CTGTATCGAGTAATGAAATTGGTTGCTAGAAAGTCGATGATTTGTTGCGTATGATTAAAAATCAACCTTAAAGGCTTTATA	['CTAGAA', 'CTTAAA', 'GCTAGA', 'TATGAT', 'TGCTAG', 'TTAAAA']
CTTTGTCAGGCTGCGTTGGCAGCAGCTAAACTTGCGAAGATCCCGAAACCACCAAGCCAGGCAGTATATGAAGTGTTCAAA	['AAACTT', 'AGTATA', 'ATATGA', 'CTAAAC', 'GCTAAA', 'TAAACT']
ATCGCACAATGTATTTCAATCATTGGCATTCCTGTCGGCATTGCGAACTTTAAAATTGCCGCTATTGCACTATGGCCGGTT	['AAAATT', 'ACAATG', 'ACTATG', 'CACAAT', 'TAAAAT', 'TTAAAA']
TCTTATAGACTAAATTTCACTGCTTAATATTAACTTAATAAATATCAGCTATTCTTATAAAGAAAATCTGAATTGTTTTTC	['AGACTA', 'GCTTAA', 'TAGACT', 'TATTCT']
CTTAAAAGTTTTAGTATCATATTCGTGTTGGATTATTCTGCATTTTTGGGGAGAATGGACTTGCCGACTGATTAATGAGGG	['CTTAAA', 'TAGTAT', 'TATCAT', 'TATTCT', 'TTAAAA']
TTGATTCGTTAGTCGCCGGTTACGACGGCATTAATGCGCAAATAAGTCGCTATACTTCGGATTTTTGCCATGCTATTTCTT	['ATACTT', 'ATGCTA', 'CTATAC', 'TAATGC']
AATCAGTCATGAGTGCTGTATAAAAATTGCGCAATCTATCCGCTTACTTTATGATGCGCACCAGTCACGGACTGATGGTTA	['AAAATT', 'TATGAT', 'TGTATA', 'TTATGA']
AATGATGCCGATTTTCATAGATTTACTCGCGATAAGCCCGATTTGAAGGCATAGTTTACCATGCGCTTACGGGGAAGCGTA	['ATAGTT', 'CGATAA', 'TACCAT', 'TAGATT']
AAACGCGCTTTATTTACTGAAAACAGGTGACCCGATAAGCACTTCCTCTACAATGGGGGCGCACATCAGGGAAAGTAAAAA	['ACAATG', 'CGATAA', 'GTAAAA', 'TACAAT']
ATATTTTTACAAAATAAGACAAATCAATGACATGCATAATGCTGATTTTTATGATGAATTGCCATAAACCATAGCCATGTT	['ATAATG', 'CATAAT', 'TAATGC', 'TATGAT', 'TTATGA']
AACACTTATTCAGCTCTATAACACCTGAAAAATAGGGATGTGCATCTTTATATATTCTGAATATTCACACTCTTTACAGGA	['ACACTT', 'CACACT', 'CTATAA', 'TATATT', 'TATTCT', 'TCTATA']
GTTTATTATCCTCAACCTGTATATTCGTAAACCACGCCCAATGGGAGCTGTCTCAGGTTTGTTCCTGATTGGTTACGGCGC	['TATATT', 'TATCCT', 'TATTAT', 'TGTATA']
CGTAATCGAAAGATAAAAATCTGTAATTGTTTTCCCCTGTTTAGTTGCTAAAAATTGGTTACGTTTATCGCGGTGATTGTT	['AAAATT', 'AAGATA', 'AGATAA', 'CTAAAA', 'GCTAAA', 'TAATTG']
ATACTCTACTAAGAAAAAAACACTGAATGCTAAAACAGCAAAAAATGCTATTATCCAATTACCTGATGTCAGGTGCTCGTT	['AAAATG', 'ACACTG', 'ATACTC', 'ATGCTA', 'CTAAAA', 'GCTAAA', 'TATTAT']
AATAACCACACTGTGAATGTTGTCTTTAATCAATTGTAAGTGCATGTAAAATACCACTTTAGAGTTAGTCAGTATCTTCCT	['ACACTG', 'CACACT', 'GTAAAA', 'TAAAAT', 'TAGAGT']
CCCGAGAAGCGATATCCATACAAACAGATGAAGATTGCAGCCGTAACGTCTATAATCAGCGCCCCACACAGAGGTAGAACA	['ATAATC', 'CTATAA', 'TAACGT', 'TATAAT', 'TCTATA']
CTGCATTCCAGGGGAGCTGATTCAGATAATCCCCAATGACCTTTCATCCTCTATTCTTAAAATAGTCCTGAGTCAGAAACT	['AGATAA', 'ATAATC', 'CTTAAA', 'GATAAT', 'TAAAAT', 'TAATCC', 'TATTCT', 'TTAAAA']
GCAAGTATCAGAGCTGCCGTTTTTGCTTCATACTTACACCCTTCAACAATAAAAATGAGAGGGAATGCTTTTGGCCGGGAG	['AAAATG', 'ACAATA', 'ATACTT', 'CATACT']
ATTTAACTCACTAAAGTTAAGAAGATTGAAAAGTCTTAAACATATTTTCAGAATAATCGGATTTATATGTTTGAAAATTAT	['AAAATT', 'AGAATA', 'ATAATC', 'CTTAAA', 'TTAAAC']
ATACAATGTGCTTTTTATTAGATTAATTTTGATAATCAATAATACTGATCATATTTTCGAATGAAAATCCTCAGTAAGCTG	['ACAATG', 'ATAATC', 'ATACTG', 'GATAAT', 'TAAGCT', 'TACAAT', 'TAGATT']
ATAAGATGAAGCCGGCGAATGCCGGCTTTTTTAATGCGATAATTTAATCTTATGGGTGGCGCACAATGAATACCCTTCCAG	['ACAATG', 'ATAATT', 'CACAAT', 'CGATAA', 'GATAAT', 'TAATCT', 'TAATGC']
TAACAAAATAGCCATTGCACCGGGTTGAACAATTTACAAAAGAAAGATATTCCATATCGTATAATGCGATTAAATACGCCG	['AAGATA', 'ACAATT', 'ATAATG', 'TAATGC', 'TATAAT', 'TATCGT']
GCGCAGTTTGAGGTAAACCTATACGCTTTATTCACATCCAATGCCTGATATACTCGTTTGTCTTGCCAATTACGGAGTAGA	['ATACTC', 'ATATAC', 'CCTATA', 'CTATAC', 'GGTAAA', 'TACGCT']
AAATTGAATTTTTTTCACTCACTATTTTATTTTTAAAAAACAACAATTTATATTGAAATTATTAAACGCATCATAAAAATC	['ACAATT', 'TATATT', 'TTAAAA', 'TTAAAC']
ACTTATCGTCAGCGGACAGGTCAGCTTTGATGACTTCAGCGGTGGGCTTAAAATGACCGCTCGCGAAGTGATGGATATTGA	['AAAATG', 'CTTAAA', 'GCTTAA', 'TAAAAT', 'TATCGT', 'TTAAAA']
CGGGGTTTTACACTATGAACGGATTAATCCTGGAATTAGCAAGAAAAACGCCAGATTGTCGCGAAAAACGAGATCTCTCCT	['ACACTA', 'ACTATG', 'TAATCC', 'TACACT']
CTTATTATCATTTCAGAGGAATTATTTGATTAAGGTTTTACTTAAGGCGTAACAAATGATATTTATCGGCTAACTGAACTT	['GGCTAA', 'TAAGGT', 'TATCAT', 'TATTAT']
CAATACAACTTTAACTGCCTTAAATCAAAAATTGTCGCAGCAAGGTTAACTAAAATCCCAGTTCGTTAACATTTTTGCGTT	['AAAATT', 'CGTTAA', 'CTAAAA', 'CTTAAA', 'TAAAAT', 'TAACAT']
CTGGAAAGTCACATCGATGCGAATTGATAATAATTCAACCGCAACAGCAGTATTGTATAAATAAGGATGTTCACAATGGAA	['ACAATG', 'ATAATT', 'CACAAT', 'GATAAT', 'TAATTC', 'TGTATA']
GTTGATGACTCATTATCTATTTCCGAACAAGGAGGGAAAATCCGTCGCTATCGTATACCAAAATGCGACAATAGGCGCGTT	['AAAATG', 'ACAATA', 'GACAAT', 'GTATAC', 'TATCGT']
ACGATGTATGTTCTAATAAAATAGATTGGGTGGGTTGTATATTGACGTTAGTATAAATAGTATTAATGCCGCTTGCATGAA	['AGTATA', 'TAAAAT', 'TAATGC', 'TAGATT', 'TAGTAT', 'TATATT', 'TGTATA']
GTAGGGAGTGAAATTAGTGTTGTGAAACGGTAATATTTGATGACTGGTTTCAAAAATTTTGCAGGCAGACTATGTGGTCAG	['AAAATT', 'ACTATG', 'AGACTA', 'GACTAT']
GCGCACAATTGAAGCCAGAGTCTTATTTTTTATATTGAAAAATATGTTAATTTAAACACTATGAGAGATGATGCTTAACTT	['ACAATT', 'ACACTA', 'ACTATG', 'ATGTTA', 'CACAAT', 'GCTTAA', 'TATATT', 'TTAAAC']
TCAGAAGAAGCAAAAAGACACTTTACCGAAGGGTTTAACATTTTTTCGTGATACTCATCACCATGACGCAAATGCGTTGCA	['ACACTT', 'ATACTC', 'GACACT', 'GATACT', 'TAACAT']
TATTTTCGCTATGGTTATGCGTAAGCATTGCTGTTGCTTCGTCGCGGCAATATAATGAGAATTATTATCATTAAAAGATGA	['ATAATG', 'TATAAT', 'TATCAT', 'TATTAT', 'TTAAAA']
CTGTTACCCCGTTCCGGTGGCAGATATAACGGCAAGTTTCGACATTGCCGATAATAATTTTTTGGAGACTTTAGATGGCTA	['ATAATT', 'CGATAA', 'CTGTTA', 'GATAAT']
TGATTGCATTACATACAGATATAGCACAGGCTATATTATATAGCTATTGCTAAAACGTTAATTTTTTGTACCTTCGCAACT	['CGTTAA', 'CTAAAA', 'GCTAAA', 'TATATT', 'TATTAT']
TAAAAAAATCGATCTCGTCAAATTTCAGACTTATCCATCAGACTATACTGTTGTACCTATAAAGGAGCAGTGGAATAGCGT	['AGACTA', 'ATACTG', 'CCTATA', 'CTATAA', 'CTATAC', 'GACTAT']
GTTTCATGGCTTAAACGTCATTTATTCTCTTGAGTCGTCGAAATCGTCGCTAAGATAATTATACTCAACGGATTCACCTCT	['AAGATA', 'AGATAA', 'ATAATT', 'ATACTC', 'CGCTAA', 'CTTAAA', 'GATAAT', 'GCTAAG', 'GCTTAA', 'TATTCT', 'TTAAAC']
CTTAAAAAGTTCCCTTGCATTTACATTTTGAAACATCTATAGCGATAAATGAAACATCTTAAAAGTTTTAGTATCATATTC	['CGATAA', 'CTTAAA', 'TAGTAT', 'TATCAT', 'TCTATA', 'TTAAAA']
GCAGGTTATAAAACCAGCACGTCCTTGCAATAGTTTCAGTATGGTATTAGCATTGATGCGTTAGATGATGGCTATCTCACT	['ATAGTT', 'ATGGTA', 'GTTAGA', 'TAGCAT']
GAATATTCACGGGCTTTTTTTATTATTTAATAAATATAAATACATTCTGATAATGCATCCTGCCGCTGGACATTATTTCAG	['ATAATG', 'GATAAT', 'TAATGC', 'TATTAT']
ATTGACAGAGATGTGCTTATTTTTTGAACGATATATTTTTACAAAATAAGACAAATCAATGACATGCATAATGCTGATTTT	['ATAATG', 'CATAAT', 'TAATGC', 'TATATT']
AAAGTTTCAATATGGAACATTCATTAAAGCATATGTTTCACTATGAAACATAATTTGGGCTAATTTTCTTTTCCCTTGCCT	['ACTATG', 'ATAATT', 'CATAAT', 'GGCTAA']
AAAACTAGAATTAACGATAAATAACCGTATTTTTAATTCTTTTTTGTTATTAAAATTCACATTTTTAACACTTAGTATCAA	['AAAATT', 'ACACTT', 'CGATAA', 'CTAGAA', 'TAAAAT', 'TAATTC', 'TAGTAT', 'TTAAAA']
CATATTCTGCCGCTAAACAATTCCCCATTCCTGGCGTATATCTGGCTAACATTCATCAATGTGATAGATTCCTCTCCCGCA	['ACAATT', 'CGCTAA', 'CTAAAC', 'GCTAAA', 'GGCTAA', 'TAACAT', 'TAGATT', 'TATTCT']
TAGCAGAGAAGACAAGGTTATATTTGGCGGGCGTTTGGCCGAGTATAAATATTATGATATGCATCAAGTGATATCTGCCGC	['AGTATA', 'GAGTAT', 'TATATT', 'TATGAT', 'TATTAT', 'TTATGA']
AGCATCACCGACAGTTCTGGAGGATACCATTGCTGATATAGCCAGAAAATATAATGCTTCATCCTGGAAAGTCACATCGAT	['ATAATG', 'TAATGC', 'TACCAT', 'TATAAT']
GATGGCTGGATGTCTAAAATAAACATTGCTTCATATGTTCAACTATGCGTTAATGATTGCGTCGGTTTGAAGAACAGACGA	['ACTATG', 'CGTTAA', 'CTAAAA', 'TAAAAT', 'TCTAAA']
GAGGGTGTTTATATTGATGATATTATGTCGCCCTATAACTATACATGATGTCAATAAGAGACAAAGATGATTAAAACAACG	['CCTATA', 'CTATAA', 'CTATAC', 'TATATT', 'TATTAT', 'TTAAAA']
ATTAGTGTGATAGGAACAGCCAGAATAGCGGAACACATAGCCGGTGCTATACTTAATCTCGTTAATTACTGGGACATAACA	['AGAATA', 'ATACTT', 'CGTTAA', 'CTATAC', 'TAATCT']
AAATCAGAAACATAAAGGCGCTTTCGGGTGCCTTTATTATTTCCAGTGAAACCCATAAAAATTAATAAGATATTCTTCTGC	['AAAATT', 'AAGATA', 'TATTAT', 'TATTCT']
TTATTCCATCTTGCATGTCATTATTTCCCTTCTGTATATAGATATGCTAAATCCTTACTTCCGCATATTCTCTGAGCGGGT	['ATGCTA', 'GCTAAA', 'TATTCT', 'TGTATA']
TTCAGCGATCATTGTTTTATCAGGCTCCTCCAGATAATTGTCGTCATGCCGGAAACCCCTGGCGGGGCTATTTTACCGCGA	['AGATAA', 'ATAATT', 'GATAAT', 'TAATTG']
CTTTCGCCAAAAGATGAAAGGCTCTTTACGTTAGATGAGCTTATCAGATTAAAATTAATTGCATGAATACGAATAAATTAT	['AAAATT', 'GTTAGA', 'TAAAAT', 'TAATTG', 'TTAAAA']
GTTTAGCCTCATGTACGATTCTTTGCCAGGCTTAATGCCAACCAGATTGTAGTAAGCCACGAGCAGATGCTTACGTACATG	['GCTTAA', 'TAATGC', 'TACGAT', 'TAGCCT']
TCCTAAACGAAATCCATGTGTGAAGTTGATCACAAATTTAAACACTGGTAGGGTAAAAAGGTCATTAACTGCCCAATTCAG	['ACACTG', 'CTAAAC', 'GGTAAA', 'GTAAAA', 'TAGGGT', 'TTAAAC']
TTTATGTGATTTGTATCACATAAAGATTGATTTTTGTGATGGTTGTCATATTATAAGCGCAAAGACAATAACACCTGTATA	['ACAATA', 'GACAAT', 'TATTAT', 'TGTATA']
TGAGTCATGGTATGAAGATACGCAGATTTACTCTTGCTTTAAAATGAATAATATTAAGCCACTTATTCACGAATCGAGAAT	['AAAATG', 'AAGATA', 'ATGGTA', 'TAAAAT', 'TTAAAA']
ACATAGTCTGCCTGCAAAATTTTTGAAACCAGTCATCAAATATTACCGTTTCACAACACTAATTTCACTCCCTACACTTTG	['AAAATT', 'ACACTA', 'ACACTT', 'TACACT', 'TAGTCT']
GCCCGCGTTGAATTACACAATGAAGAACAGCTTTATATTGCCAGTGCCACCGCCACCTATATGGTAGGTTGAAGACATAAA	['ACAATG', 'ATGGTA', 'CACAAT', 'CCTATA', 'TATATT']
TAATGCGGAGAATCAGTACACTATTTTCTTATAATTACATTTGAAATTATATGATCACCGGGAGTGATTGATTAATTATCT	['ACACTA', 'ATAATT', 'ATATGA', 'TAATGC', 'TACACT', 'TATAAT', 'TATGAT']
AACGTTTTCTTTTTCTGTTAGAATGCGCCCCGAACAGGATGACAGGGCGTAAAATCGTGGGACACATATGGTCTGGATTGA	['CTGTTA', 'GTAAAA', 'GTTAGA', 'TAAAAT']
GTAAAATGACTCTCGGCATTCGCCCGGAACATATTGCGCTAAGCTCGCAGGCAGAAGGCGGCGTACCGATGGTGATGGACA	['AAAATG', 'CGCTAA', 'CTAAGC', 'GCTAAG', 'GTAAAA', 'TAAAAT', 'TAAGCT']
TTACAAATTCTTTGCACTTCCCTGCACTATCCGACACTGTCACCATCCATAATTCAGGCTTATCTGTTTATTACAATAACC	['ACAATA', 'ACACTG', 'ATAATT', 'CATAAT', 'GACACT', 'TAATTC', 'TACAAT']
CTTTATCTCAAAAGCGTTGCGCCTTTGTTGTATCGTCAGTTCAGGGTAAAATAGATTTCCGTTAACCACCTGGTCAGGACG	['CGTTAA', 'GGTAAA', 'GTAAAA', 'TAAAAT', 'TAGATT', 'TATCGT']
CTATACTTATCTTTACATCTACAAAACACTACTTGAGACAATCATCGCAATATTAGTTAAATCGCGGTTTTTGATTAGTTT	['ACAATC', 'ACACTA', 'ATACTT', 'CTATAC', 'GACAAT', 'GTTAAA']
AATGTGGTGCTGGCCAATTAATTGCGGTTGGTAATAAAAGTCTGGCTCCCTATAATGAGCCAGACTTTTTACCGCTGTAAT	['ATAATG', 'CCTATA', 'CTATAA', 'TAATTG', 'TATAAT']
TTACGTTAGTAATCACACTATTGATGTTTGGTTAAGATACGCAATGGTGAAATCGACGCCATGTATAACCATTGATTTCAT	['AAGATA', 'ACACTA', 'CACACT', 'TGTATA']
TATTATGATATGCATCAAGTGATATCTGCCGCTCTTTATCAAGTGAAAAATATAATGAGTACGGATTAATGATCTATCTTG	['ATAATG', 'TATAAT', 'TATGAT', 'TATTAT', 'TTATGA']
TCCGGCTAATCTGAGGCATAACAATTTCCATCAACAAAAATCCAACAAATAATATCATTTATCCTGCTGTAAAAAAAACGC	['ACAATT', 'GGCTAA', 'GTAAAA', 'TAATCT', 'TATCAT', 'TATCCT']
TATCTGTTGCTTTTGCAATCTTAATCGTTAAAACTACCAACAAATTTATATAGTTACGTTGTGAAATGTTGTTAATTTTTT	['ATAGTT', 'CGTTAA', 'GTTAAA', 'TTAAAA']
GACAAAGCGAATGTCACAGCGAAAAAAGTGACTTTTCTTGTCGCTGCGTACACTGAAATCACACTGGGTAAATAATAAGGA	['ACACTG', 'CACACT', 'GGTAAA', 'TACACT']
GACACAATTTAATCGACAATAATGGTCGTCGCCTCGCTCGCAGTGTGCTAACGTTTATCTTCTTTAAGCCCCTGGTAGAAG	['ACAATA', 'ACAATT', 'ATAATG', 'CACAAT', 'GACAAT', 'TAACGT']
TGGATTATAAATCTCATTATCTTAATTGCAACGGGGTCCAGCCGTGGTTATAATTCGTTCGTTGGAACACGATGTTGCACA	['ATAATT', 'TAATTC', 'TAATTG', 'TATAAT']
ATTCAGATTGATGATCCTAACAATCCCGGCGAAAAAATGAGTCTGGCACCGTTTATAGAACGAGCTGAAAAACTCTGTTAA	['AAAATG', 'ACAATC', 'ATCCTA', 'CTGTTA']
ATCGGTTGCTGCCTGTACGGCGCTGCCTGCACCTATGATAATTCGCCTGACGAAGATTTTATTATCGATACCCTACCCGGC	['ATAATT', 'GATAAT', 'TAATTC', 'TATGAT', 'TATTAT']
GGGTTACTCTTCAGGCAGTTAAATGGGCATTTCTACACAGATAATGCGATGTTCAGATTCTGTAGACTTATAATGATAGAT	['AGATAA', 'ATAATG', 'GATAAT', 'GTTAAA', 'TAATGC', 'TAGACT', 'TATAAT']
GTGCGACCACTCACAAATTAACTTTCAATACTTTCCAGAGTATCGTTATTACAATTAAATACCTTTAAATATCAACAAGTT	['ACAATT', 'ATACTT', 'GAGTAT', 'TACAAT', 'TATCGT']
AGGCAACCACAGGCTGCCTTTTTCTTTGACTCTATGACGTTACAAAGTTAATATGCGCGCCCTATGCAAAAGGTAAAATTA	['AAAATT', 'GGTAAA', 'GTAAAA', 'TAAAAT']
AGGCTGATGGCCGCTATACCGTTAAGGTATTGAAAGAAGAAAGCAAAAAATAATTAGCTCGTACAAGGGAAGTGGCTTGCC	['ATAATT', 'CGTTAA', 'CTATAC', 'TAAGGT']
TTTGGCGTGTGGCAATTCTTAAAACATTGTCTAACATGCTTGTTACCGTCATTATCATCCGTGGTCCATCCTAACATCCTT	['ATCCTA', 'CTTAAA', 'TAACAT', 'TATCAT', 'TTAAAA']
GATATGAAAAATGACGCAGACAGTTACACCGTTTAAATGCAATAATCAGCCACGTTTCTCGTTAATAACAATACCAGTACC	['AAAATG', 'ACAATA', 'ATAATC', 'ATATGA', 'CGTTAA']
ATAATGATAAGTGTTTTTACCACTTCCCCTTTTCGTCAAGATCGGCCAAAATTCCACGCTTACACTATTTGCGTACTGGCC	['AAAATT', 'ACACTA', 'ATAATG', 'TACACT']
TAATTAATTTATATATTTAATGCATTAATTCTTAACATTAATTGATCAATAATATTCACCAAATCAATATCAAAAAAAATC	['TAACAT', 'TAATGC', 'TAATTC', 'TAATTG', 'TATATT']
TTCGCGATATGGCAGGACAAGACGTAAAATTGACAGCAATTTTATTCATATAAAGAATGAATCGCAGCCAAGGCATTCATC	['AAAATT', 'CATATA', 'GTAAAA', 'TAAAAT']
ATTTATTCTGATAAAAAACAACACACTAAATATAAAATTATTTCTTGCAGTAATTATAAAAGCCGAAAACAGAACTCAAAA	['AAAATT', 'ACACTA', 'CACACT', 'TAAAAT', 'TATTCT']
GAATTCCGCATTTCTCACACAATTTATAACGTAACTGTCAGAATTGGGTATTATTGGGGCAGGTTGTCGTGAAGGAATTCC	['ACAATT', 'CACAAT', 'TAACGT', 'TATTAT']
TGCTAATAGTATGCCATGGATCTTTTTCCCTTGAGGGATGTTATTAGACCGCTATACTGGGCAGACAACAGTTCAGATTTT	['ATACTG', 'ATGTTA', 'CTATAC', 'TAGTAT']
AACAATTAATGACACAAGAAATACGATTAAAGATTTTTTTGTGCATGCCGATAGTGCTTTTTTAAAAGGAGAAATCTATGT	['ACAATT', 'ATAGTG', 'TACGAT', 'TTAAAA']
CCGATGTATGATAAATAACGGAAGCATTTGAATGGATAATATACAGTATACATTCTATTAATATTTATGATATAATTCTTT	['AGTATA', 'ATAATT', 'ATATAC', 'GATAAT', 'GGATAA', 'GTATAC', 'TAATTC', 'TATAAT', 'TATGAT', 'TTATGA']
CTTTTTTATTTGTATTCGGTGACTTTCTGCGTCTTGTGGGCTGACAATTGCCCCCGTTTCTTGTCACAATAGGCCTTTGCG	['ACAATA', 'ACAATT', 'CACAAT', 'GACAAT']
AATAAGTCGCTATACTTCGGATTTTTGCCATGCTATTTCTTTACATCTCTAAAACAAAACATAACGAAACGCACTGCCGGA	['ATACTT', 'ATGCTA', 'CTAAAA', 'CTATAC', 'TCTAAA']
GTGACGCTTCAGGGGGTAAACGACAAAGTGTATACCCTGGCGAAATTGTATAATTTGCCTGCTGATGTTCTGCCTCGTTAA	['ATAATT', 'CGTTAA', 'GGTAAA', 'GTATAC', 'TATAAT', 'TGTATA']
ACCAGCCACTCCCTGACTGACAATTACGTTAGCATCTGCGGATCATGCTAAAATCGCCGCCTGACAATTATTCACTCAAGG	['ACAATT', 'ATGCTA', 'CTAAAA', 'GACAAT', 'GCTAAA', 'TAAAAT', 'TAGCAT']
ATTAATTACACTAATGCTTCTTCCCTTCGTTTTAGCGCCCCGCCGCAGTATCATGATATCGATAACCATAATAAATGTGTG	['ACACTA', 'CATAAT', 'CGATAA', 'TAATGC', 'TACACT', 'TATCAT']
TGCCCGTAAAGTGGCGAATCGGGTGATCTTTATGGACGAGGGTAAAATTGTCGAAGACTCGCCGAAAGACGCTTTCTTCGA	['AAAATT', 'GGTAAA', 'GTAAAA', 'TAAAAT']
ATCAATTGGCTTACCCGCGATAAAATGTTACCATTCTGTTGCTTTTATGTATAAGAACAGGTAAGCCCTACCATGCCACAT	['AAAATG', 'ATGTTA', 'CGATAA', 'TAAAAT', 'TACCAT', 'TGTATA']
AATAGCGTCAGTGGTGTTAGGCACGGCATTGAATGACAGGTATGATAATGCAAATTATAGGCGATGTCCCACAATTGACCG	['ACAATT', 'ATAATG', 'CACAAT', 'GATAAT', 'TAATGC', 'TATGAT']
GAAATGGTCACCATCAACTTCTTTATCATTGATTAAAATTAAATCAGAAGATCATCACAGAGGAGAGCACACAAAGTCAGC	['AAAATT', 'TAAAAT', 'TATCAT', 'TTAAAA']
GAAAATGAAGGCTCCTTCGGGAGCTTTTTTGCTTGGTGTCTATTCGATGGATACTCACATACTACGGTAACATCATGAAAA	['AAAATG', 'ATACTC', 'CATACT', 'GATACT', 'TAACAT']
GGTTGTCGATAAACGCTCACTTGGTTAATCATTTCACTCTTCAATTATCTATAATGATGAGTGATCAGAATTACATGTGAG	['ATAATG', 'CGATAA', 'CTATAA', 'TATAAT', 'TCTATA']
AAATTTTAGTGAGGCATAAATCACATTACGCAACGATAATAGCGGGTATAAGATAAATAAAAGGTAAAACGTTTTATCTGT	['AAGATA', 'AGATAA', 'CGATAA', 'GATAAT', 'GGTAAA', 'GGTATA', 'GTAAAA']
GATTCAAAAAAAAGTGGAAATAGGGTGAAGAATTGACCTAAAATAGCCATCCAGATGTTAATCCATCCATACCGATTAACA	['ATGTTA', 'CTAAAA', 'TAAAAT', 'TAATCC', 'TAGGGT']
TCTGCCTCTTTTCAGTGTTCAGTTCGTTAATTCATCTGTTGGGGAGTATAATTCCTCAAGTTAACTTGAGGTAAAGCGATT	['AGTATA', 'ATAATT', 'CGTTAA', 'GAGTAT', 'GGTAAA', 'TAATTC', 'TATAAT']
TTTGGGTTTCGAGGCTCTTTGTGCTAAACTGGCCCGCCGAATGTATAGTACACTTCGGTTGGATAGGTAATTTGGCGAGAT	['ACACTT', 'CTAAAC', 'GCTAAA', 'TAAACT', 'TACACT', 'TGTATA']
TTGCTGTAACATAATTGCTTTAATTGTTAATAATATTTTGCAATCAAGTTATCATAATCAAACAACTTCACTTGTCAGCGA	['ATAATC', 'ATAATT', 'CATAAT', 'TAACAT', 'TAATTG', 'TATCAT']
AAGATAATACATACAAAATAAAAATTATACTTTTAATTTGCTATACGTTATTCTGCGCGGGTTATATGCCTTTATTGTCAC	['AAAATT', 'AAGATA', 'AGATAA', 'ATACTT', 'CTATAC', 'GATAAT', 'TATTCT']
TATTATGCGTGAGAATTTACGTTATGTAATTCAGTATCACGCCCATACAATCCGAATTTTAGTGAGAATTGTGGCTCAGAC	['ACAATC', 'TAATTC', 'TACAAT', 'TATTAT']
TCTGTATAGATAAATTTACACTCCCTTTGAAAACAATCCGCTATGCTTTGAAAAAGGAGAAAGAAATGATGAAAAAGTTTA	['ACAATC', 'AGATAA', 'TACACT', 'TGTATA']
GTGGGGCAGTGTCTACGATCTTTTGAGGGGAAAATGAAAATTTTCCCCGGTTTCCGGTATCAGACCTGAGTGGCGCTAACC	['AAAATG', 'AAAATT', 'CGCTAA', 'TACGAT']
AACAATTTCTTTAGAAAATGCGTTGACTCATTTTGAACTCTCCCTATAATGCGACTCCACACAGCGGGGGTGATTAGCTCA	['AAAATG', 'ACAATT', 'ATAATG', 'CCTATA', 'CTATAA', 'TAATGC', 'TATAAT']
GTAGAGCGGATAAGATGTGTTTCCAGATTGACTTATCCTCACTAAAGGATAAAACTTATAATATCCCCTTAAGCGGATAAA	['AAACTT', 'GGATAA', 'TATAAT', 'TATCCT']
CGCCGACTACCGCTTTCGATATATTGACTCAATTTTCCAGCCTGGTTAAAAATAGCGACCAGCTCAGTCGCAAATATAGTG	['ATAGTG', 'GTTAAA', 'TATATT', 'TTAAAA']
TCATTGATGGTATTTTATATGTTTAAAAAATCTGTTTTATTTGCAACACTATTATCTGGCGTTATGGCATTTTCCACCAAT	['ACACTA', 'ATGGTA', 'TATTAT', 'TTAAAA']
GCTAAACGCGGTTGTATAACCGCAATACACGCCGTATTTTATCCGGCATATATTGTTTTTGCTTGCTCATGGAATAGGGAG	['CATATA', 'CTAAAC', 'GCTAAA', 'TATATT', 'TGTATA']
TAAAAACCGTTTCAGAATTTATTACCCGTCACGCTTTACCCGAACAGGTATACTTTGTCTGTTATGATGAAGAAAACGCCC	['ATACTT', 'CTGTTA', 'GGTATA', 'GTATAC', 'TATGAT', 'TTATGA']
CATTATACGGACTTCCGGCGGTTATTCCTATCCTGACAAGGCATCGATGGCTATAATCCTTCCACCTCTCCTTTTATAAAC	['ATAATC', 'CTATAA', 'TAATCC', 'TATAAT', 'TATCCT']
CTTTCGGGGCAAAATGTATCTTTTGTAAATCAATGATGATTACATTTGATAATATTTCACAATACTTAAATGCCAGCCGTC	['AAAATG', 'ACAATA', 'ATACTT', 'CACAAT', 'CTTAAA', 'GATAAT']
TTTATACTCTTTTGAATACATAGAAAATTGATATCAATATAATGAAAATATCAAATATTTGCATATAAATATAATCTTAAA	['AAAATT', 'ATAATC', 'ATAATG', 'ATACTC', 'CATATA', 'CTTAAA', 'TAATCT', 'TATAAT']
TGGCACTATGTCCAATAAAGAAAGTAGCGATCGGTTATAAAAGCCTTATAATAACGCCCCTAAAATTAGATTTGCCTGTTT	['AAAATT', 'ACTATG', 'CTAAAA', 'TAAAAT', 'TAGATT', 'TATAAT']
CGCCTCGGTAGCGGTAAGCTAATTGTCATTACGCTTATCAGCGCCCTGTTAAGCGGCTATGTGCAGCAAAAATTCAGCGGG	['AAAATT', 'AAGCTA', 'CTGTTA', 'TAAGCT', 'TAATTG', 'TACGCT']
CTGCTCCAGATTTTGCGATGTTTTTTTGCCCAGCACACTGAGAACGTGAGATACTCACAACTGTATATAAATACAGTTACA	['ACACTG', 'ATACTC', 'CACACT', 'GATACT', 'TGTATA']
CATACATTAGCTTACAATCGCTTTAAATATGACAGCATAACCTTTACATAATTTAGTTCCAGAAAACAATCATTCGGAAAA	['ACAATC', 'ATAATT', 'ATATGA', 'CATAAT', 'TAACCT', 'TACAAT']
TTTGTGTTATTTCACCTAATCTTTAGGATTAATCCTTTTTTCGTGAGTAATCTTATCGCCAGTTTGGTCTGGTCAGGAAAT	['TAATCC', 'TAATCT', 'TAGGAT', 'TTAGGA']
GACGCGGTGATGAAGTGATCGAACTGGCGAAAACAAACTGGCTAAGGTAAAAAGGGTGGCATTTCCCGTCATAATAAGGAC	['CATAAT', 'GCTAAG', 'GGCTAA', 'GGTAAA', 'GTAAAA', 'TAAGGT']
AGAGCGGCGTTTCTCGCCCTGTTCCGCAGCTAAAACGCACGACCATGCGTATACTTATAGGGTTGCTGGTGCAAAATCCAG	['ATACTT', 'CTAAAA', 'GCTAAA', 'GTATAC', 'TAGGGT']
TCAAATGGTATGCTGGTTTATTTCATGTAAAAGAATAAAATATCTGTATAAAATCATGCCACTGGCAATCTGCATCAACTC	['AGAATA', 'ATGGTA', 'GTAAAA', 'TAAAAT', 'TGTATA']
GCCGTAAGCCGTTCATCCTGACCAGTGCCGCTGTTCATATTTGCTCATTAAGATCGCTTCACTAAACCATAATTCTACAGG	['ATAATT', 'CATAAT', 'CTAAAC', 'TAATTC']
TTAAGTGATTTAATTGATTTAATGAATAAAATTTGCCACGATCATAATTAATATCTATGTATTTTGATTCAACATTTTAAT	['AAAATT', 'ATAATT', 'CATAAT', 'TAAAAT', 'TAATTG']
ATACCCAATGCTGGTTGAGCATTTGTTGAAAAAATTTTCCCCCGTTTTGACTAAAATGCGCCAGGATTGATGGAATCATTA	['AAAATG', 'AAAATT', 'CTAAAA', 'TAAAAT']
GTGGTGGAAGAAGATCCGGGCGTTAAATCGGTGCGCAATATCTACGACTACTATAAGCAACACCACTATGAAACCATTGTG	['ACTATG', 'CGTTAA', 'CTATAA', 'GTTAAA']
GAACATATTTTTTAAATGCAATTAATTGACAAACTAAATCACATCTAAATACAATGTATAAAACAAAATAACTATACATAC	['ACAATG', 'CTATAC', 'TAATTG', 'TACAAT', 'TCTAAA', 'TGTATA']
TGTGCGGTCAAATCGTCCACTAATTTCTCTCTTCACTTAAACCAGATACACTTGTCGTTTAGTTTATCTGGTTTATGACGG	['ACACTT', 'CTTAAA', 'TACACT', 'TTAAAC', 'TTATGA']
ATTTATCCTGTAAAAAAATATGTACATGAGAAATTACTATAAAAATTTGTACTATTAGTAAAACTCGTTATTTTTATGCAT	['AAAATT', 'CTATAA', 'GTAAAA', 'TATCCT']
TCAGTATTCCCCAATCAGTGTAGTGCCTTTAAACATAACGTGCGTAAATATATTGTCCCCGATCACACTTTTTAGTGAAAA	['ACACTT', 'CACACT', 'TAACGT', 'TATATT', 'TTAAAC']
AAATACGTCAAAATTCGTGCCGAAATTGCGCGTTCTGCGCGGAACACGTATACTTTCAGTGTTGACATAATACAGTGTGCT	['AAAATT', 'ATACTT', 'CATAAT', 'GTATAC']
GCGGCGTAATCAAAGCTGAAGTTGTTGCTCACGGTCGTGGCGAGAAAGTTAAAATCGTTAAGTTTCGTCGTCGTAAACACT	['CGTTAA', 'GTTAAA', 'TAAAAT', 'TTAAAA']
CAACGCCTGGCACTGCCGGGCGTTGTTCTTTTTAACTTCAGGCGGGTTACAATAGTTTCCAGTAAGTATTCTGGAGGCTGC	['ACAATA', 'ATAGTT', 'TACAAT', 'TATTCT']
ACGGTAAAGCCCCTGCGTTTGCTGGGTTGAACTGATAATCATTATCACTAACATGCTGTTATACGCTGAAAGCGATGAAGT	['ATAATC', 'CTGTTA', 'GATAAT', 'GGTAAA', 'TAACAT', 'TACGCT']
CAATAGACATTTTTAACATGTTGTTTTTCTAAGTGTTATAAGGTAGGTATAAAATGGGATGGAGCCTCTGCTTCTGGCATG	['AAAATG', 'GGTATA', 'TAAAAT', 'TAACAT', 'TAAGGT']
TTCATAAGGAACAGTGAAGTAAGATCTAAGAGGAGTTAAATTTTATACAGTATAATCATAATATTGCAGCAAGGTGGTTAT	['AGTATA', 'ATAATC', 'CATAAT', 'GTTAAA', 'TATAAT']
ATCATTTTCCATTGCCCCATTCTTGATGATAATCCGGCAGCGGTAATTATACAGTCGATGGCTGACATAGTGGTTCCATTA	['ATAATC', 'ATAGTG', 'GATAAT', 'TAATCC']
ACATCAATACAAAAGTTGGAATATTTTTCCAAAACTAGATTTAGTCCACAAATTGAACAGGGTTATCATGTAAAAATACTG	['ATACTG', 'GTAAAA', 'TAGATT', 'TATCAT']
TAGGTTCTAAATAAATGAGCGTTTTTTGATAGTCTATTTCATTAGGTAATATATATTTGTAACAAATCAATCAAAATGGAA	['AAAATG', 'TAGTCT', 'TATATT', 'TCTAAA']
GAGACTATCCGGTCTTTTACCAAATAATGAAGAATAATCCCTCCCTGGAAGATAATTGTAAAAAACAACAGCATAAGAATT	['AAGATA', 'AGAATA', 'AGACTA', 'AGATAA', 'ATAATC', 'ATAATG', 'ATAATT', 'GACTAT', 'GATAAT', 'GTAAAA', 'TAATCC', 'TAATTG']
AGAAAAAAGCAGCAAACTTCGGTTGAAAAAGCCGCTATGATCGCCGGATAATCGTTTGCTTTTTTTACCACCCGTTTTGTA	['AAACTT', 'ATAATC', 'GATAAT', 'GGATAA', 'TATGAT']
GAACGCAGCCGCAGAGGTGCAAACTTTGAAGCCCTGACCCCATGCCGCTATACTGCCGCCATCACTTAAAAACAGGATACA	['AAACTT', 'ATACTG', 'CTATAC', 'CTTAAA', 'TTAAAA']
AGAGTGCGACATGCCAGAATGATTAATGAAATATCAATATGAGAAAATTACAGATAATTCCATTGTCAGGTTCTCTTCTCA	['AAAATT', 'AGATAA', 'ATAATT', 'ATATGA', 'GATAAT', 'TAATTC']
GTTCTGAGCTAATTGCCGATAACATTTGACGCAATGCGCACTAAAAGGGCATCATTTGATGCCCTTTTTGCACGCTTTCGT	['CGATAA', 'CTAAAA', 'TAACAT', 'TAATTG']
TAAGGTTGTAACAAGAGGCGTATTTGCACACAATAACCACCGTGAATAGGTCTAAAGTAAAACATAAGAAATATTTGGGGT	['ACAATA', 'CACAAT', 'GTAAAA', 'TAAGGT', 'TCTAAA']
TTTACAGCAGAGTTAGCAACTGTTGATTGCAATTCCCGCAAAAATGAGTAAAATTTTCGGGCTTTTAATATGACACCGGAC	['AAAATG', 'AAAATT', 'ATATGA', 'GTAAAA', 'TAAAAT']
GATTTCAAATTGGTCAATGGTCAAAAGTTAATAAACCCATTGCTGCGTTTATATTATCGTCGTGCTATGGTACATACATTC	['ATGGTA', 'TATATT', 'TATCGT', 'TATTAT']
GATTTCGACGACTCAAGAGAATAAATGACGTTTAAGCCATGAAACAAGCTAAAATCCTGCAAAAGACGAGTTTTTACGGGC	['AAGCTA', 'AGAATA', 'CTAAAA', 'GCTAAA', 'TAAAAT']
AATATCCAGCGGATCAAGAAAATTCGTTGGATATTTTTTTTGCATGGATAAAATTATCGCCTCTAAAGTATGTAATAACAG	['AAAATT', 'GGATAA', 'TAAAAT', 'TCTAAA']
GTCTTGTGTTTAAATACGCTAACACCTAAACTTACTTTTAGTAAGTACGTACAAAAAGGTAAGTATGAAATGAGTCAGGTT	['AAACTT', 'CGCTAA', 'CTAAAC', 'TAAACT', 'TACGCT']
GCGTTTCACCGTGGCGGACTAGGTATACCTGTAACATGCTTTTTTTCCGTATACTGCTGTAACGTTAATTTTCTGAGTAAT	['ATACTG', 'CGTTAA', 'GGTATA', 'GTATAC', 'TAACAT', 'TAACGT']
TTATTTCTAAACCATCGCCGTTCCGCTGTTTTTCTCCGGTAAGGCTGCGATAATTACATCAATGGCGCAATGCGATTTCGG	['ATAATT', 'CGATAA', 'CTAAAC', 'GATAAT', 'TCTAAA']
ATTTGTTAAATACCGTTTTTTAATCCGAGCTATAGTCTCAAACCCTGGCTAAAGTTATTCTTGCGATGCTTTTATATAGCG	['GCTAAA', 'GGCTAA', 'GTTAAA', 'TAATCC', 'TAGTCT', 'TATTCT']
AATCATTCAACAAAGTTGTTACAAACATTACCAGGAAAAGCATATAATGCGTAAAAGTTATGAAGTCGGTATTTCACCTAA	['ATAATG', 'CATATA', 'GTAAAA', 'TAATGC', 'TATAAT', 'TTATGA']
GACAAATATTGATAGCCTGAATCAGTATTGATCTGCTGGCAAGAACAGACTACTGTATATAAAAACAGTATAACTTCAGGC	['AGACTA', 'AGTATA', 'TAGCCT', 'TGTATA']
AAGGCGCCAGTAGCGTTTCACACTGTTTGACTACTGCTGTGCCTTTCAATGCTTGTTTCTATCGACGACTTAATATACTGC	['ACACTG', 'ATACTG', 'ATATAC', 'CACACT']
CCTGCTTCGGCAGGTTTTTTTATACTTGACAATGTACCTTTGAGATACATAATGTACCCAAGAGAAACAACAAACAGGCAG	['ACAATG', 'ATAATG', 'ATACTT', 'CATAAT', 'GACAAT']
CGTTTTCCGGCTGCGGTCAATTGTGGGACATCGCCTATAATTTGCATTATCATACCTGTCATTCAATGCCGTGCCTAACAC	['ATAATT', 'CCTATA', 'CTATAA', 'TATAAT', 'TATCAT']
CAAACATAATTTGTATGAGTATTAACCCGCGATTCTGATGGCGCTTTTGCTACAATAAAAGCGTTGTTTCACCCTCGGTTA	['ACAATA', 'ATAATT', 'CATAAT', 'GAGTAT', 'TACAAT']
TTTTGACTGGCACATTCGGCTGCCTCAACTAGGCTGAAAAATGGTGCGATCGGACTGGTCGTACCACAATCGGCAGCTAAA	['AAAATG', 'ACAATC', 'CACAAT', 'CTAGGC', 'GCTAAA', 'TAGGCT']
TATTTAAACACGAGTCCTTTGCACTTGCTTACTTTATCGATAAATCCTACTTTTTTAATGCGATCCAATCATTTTAAGGAG	['ATCCTA', 'CGATAA', 'TAATGC', 'TTAAAC']
AAAAAGAATAAAAATAAGAATTATTATTGCTGTGCGCGCGAAGATGTTTAAACTGCGGGCTGTAATTCATTGTCCGGGTTT	['AGAATA', 'TAAACT', 'TAATTC', 'TATTAT', 'TTAAAC']
AGATCATCCGATCTTCGCCTTACACTTTTGTTTCACATTTCTGTGACATACTATCGGATGTGCGGTAATTGTATGGAACAG	['ACACTT', 'CATACT', 'TAATTG', 'TACACT']
ATGGAAATAATTCACATTAAAAATAATCGACCCTATGCTTATAAATATAATCAATATATTGATGGCAGCATCTTTATTATG	['ATAATC', 'ATAATT', 'TAATTC', 'TATAAT', 'TATATT', 'TATTAT', 'TTAAAA']
CTGGTTGATAATTAAGACTATTTACCTGTTATTAACACTCTCAAGATATAAAATTATTATCAGCGATATAACAGGAAGTCA	['AAAATT', 'AAGATA', 'AGACTA', 'ATAATT', 'CTGTTA', 'GACTAT', 'GATAAT', 'TAAAAT', 'TATTAT']
CTCCTCGCTGTTGCTTCATGGCACAGCGTTAACGCTATGTACATAGCAGCTAAAAAAATGATGAAATAGTCTATCACTTAA	['AAAATG', 'CGTTAA', 'CTAAAA', 'GCTAAA', 'TAGTCT']
TGCTTAATCCATGAGCCAGCGTGCTGAACGATACCGGGATTCTGTTGTCGGAATGGCTGGTTATCCATTAAAATAGATCGG	['GCTTAA', 'TAAAAT', 'TAATCC', 'TTAAAA']
GGGCGGTTTTTTTACATGGCACGAAAGACCAAACATTTGTTATCAAATGGTAAATAATAAGTGAGCTAAAAGTTGCTTAAC	['ATGGTA', 'CTAAAA', 'GCTAAA', 'GCTTAA', 'GGTAAA']
GTTAGCCGTTCGCTTTCACACTCCGCCCTATAAGTCGGATGAATGGAATAAAATGCATATCTGATTGCGTGAAAGTGAAAA	['AAAATG', 'CACACT', 'CCTATA', 'CTATAA', 'TAAAAT']
CTAATCATGATGAGCTATTTTTGATAGTTCATCCTGTGGCGTCGCTCTTAAACTTATATTGTAAATGACTTAGATTTAAAT	['AAACTT', 'ATAGTT', 'CTTAAA', 'TAAACT', 'TAGATT', 'TATATT', 'TTAAAC']
TCATTGGGTTCTCACTTCCTGACCATCAAAATTGACAACATCACCATCCTATAATTGACTGAAAAGGAATTAATCCCCGTA	['AAAATT', 'ATAATT', 'ATCCTA', 'CCTATA', 'CTATAA', 'TAATCC', 'TAATTG', 'TATAAT']
CTGATCTAAGCGTTGACCGAGTTGGTTTTCGGACACCGTTGCAGTGAGCTGTACTCGTTGTGCCATATATACTGCTTCTTC	['ATACTG', 'ATATAC', 'CATATA', 'CTAAGC']
AGACACACTGCGCGCCGCGAAACGCTTTACCCGCATGGCGCTTAAGCCGTATCTTGGCGGTAAACCTTTAAAGAGCAGGGA	['ACACTG', 'CACACT', 'GCTTAA', 'GGTAAA']
GGGTGATAAATGGTAAAAGTCATCTTGCTATAACAAGGCTTGCAGTGGAATAATGAGGCCGTTTCCGTGTCCATCCTTGTT	['ATAATG', 'ATGGTA', 'CTATAA', 'GGTAAA', 'GTAAAA']
GCGAGAATCACCGGGATTGCTAATGCTAATAACAGACGCGCTTCACTGATATACTTCTGCACGTGAACACCTTTTATTTGT	['ATACTT', 'ATATAC', 'ATGCTA', 'TAATGC']
CGAGGAGGGCGAGTATGGAATACCTTTCGATTTCTCTTTCGTTCCGGCTTATAATCCCCGGCCTTTGATTATTTTTTTATC	['ATAATC', 'GAGTAT', 'TAATCC', 'TATAAT']
GCCTGCACAAAATTCCACCGTTGCTGTTGCGTCGCAACCGACAATTACGTATTCTGAGTCTTCGGGTGAACAGAGTGCTAA	['AAAATT', 'ACAATT', 'GACAAT', 'TATTCT']
AGATCGCATTATAAGCTTTCTGTATGGGGTGTTGCTTAATTGATCTGGTATAACAGGTATAAAGGTATATCGTTTATCAGA	['GCTTAA', 'GGTATA', 'TAAGCT', 'TAATTG', 'TATCGT']
GTTAACATTTCGTTAAAAGATCCTTTGCTTTTTATGATTCGCGATTTAACTATTAGCAACAGAAATGTGAAACATCTGGAG	['CGTTAA', 'GTTAAA', 'TAACAT', 'TATGAT', 'TTAAAA', 'TTATGA']
TCATAAGACTTTCTCCAGTGATGTTGAATCACATTTAAGCTACTAAAAATATTTTACAAAATTTCAAATTTAATTGAAAGC	['AAAATT', 'AAGCTA', 'CTAAAA', 'TAAGCT', 'TAATTG']
TCCCTGATTTTATTGTTGACATTTCATTTATGCCGACTATTTATATGGTATACTTGTCGAATTATCTTAAAGGAAGCTCAG	['ATACTT', 'ATGGTA', 'CTTAAA', 'GACTAT', 'GGTATA', 'GTATAC']
AAAACGCAACATCTGGGTAGCATCACAGCAGAACAGTTAGAAAGCGTTTAAAATCATTCGGTCACTTCTGCGGGAGACCGG	['GTTAGA', 'TAAAAT', 'TAGCAT', 'TTAAAA']
CTAATAACATCCCTCAAGGGAAAAAGATCCATGGCATACTATTAGCAGAATAATCTACCTACGCGAGACCATGATTTTTAC	['AGAATA', 'ATAATC', 'CATACT', 'TAACAT', 'TAATCT']
TGCATTCGCTGCCGCATACCATTATTCTTGATCTGACGGAAGTCTTTTTGTAACAATTCAAACTTCTTTGATGTAAACAAA	['AAACTT', 'ACAATT', 'TACCAT', 'TATTCT']
CGTATTTCCATCGGAGTGGAAAGTGCAAACAATATTTTTTGCGACTCCATGTCCATATAATTTATCCTTAAATATTCATTA	['ACAATA', 'ATAATT', 'CATATA', 'CTTAAA', 'TATAAT', 'TATCCT']
TTTATTTAGACATCTAAACGTCTTGATTGCCAAATACTAGCATCGTGTTATAGTGCCTTCAACACGCAACTTCGTCAGGTA	['ATAGTG', 'CTAAAC', 'TAGCAT', 'TCTAAA']
GTTAAATATACCTGGTAATATTCTTCACTCCGAAGAAATACTGGTAATTTAATCTAAATAATGCCCGTCAAGGATTTGACG	['ATAATG', 'ATACTG', 'ATATAC', 'GTTAAA', 'TAATCT', 'TAATGC', 'TATTCT', 'TCTAAA']
AAATTAAGGTACTGCCTTAATTTTCTGCAGACAAAAGGCGTGACGATGGTCGAAAATGGCGCTTTCGTCAGCGGGGATAAT	['AAAATG', 'GATAAT', 'GGATAA', 'TAAGGT']
CGTGTCGGGGCGTTGACGGTAATGCATTGACCCAGGGTTGGTAAAAAATAATCATAGGGAGTAAAAACACAAATAATATAA	['ATAATC', 'GGTAAA', 'GTAAAA', 'TAATGC']
TACTGCCGCATCTGGAAATTTCCCGGTTGGCATCTCTGACCTCGCTGATATAATCAGCAAATCTGTATATATACCCAGCTT	['ATAATC', 'ATATAC', 'TATAAT', 'TGTATA']
CACTCGCTGCCAAATTGTGGCGCTAAAGCTGATTAGCACGGTGATATTTGATACTCTGGCAGACAGCAGAAATAACGGATT	['ATACTC', 'CGCTAA', 'GATACT', 'GCTAAA']
ATCGAATTCCCGTTAACTCTTCATCTGTTAGTCACTTTTAATTAACCAAATCGTCACAATAATCCGCCACGATGGAGCCAC	['ACAATA', 'ATAATC', 'CACAAT', 'CGTTAA', 'CTGTTA', 'TAATCC']
GCGAAGTCGGAAAACTTCTGTTCTGTTAAATGTGTTTTGCTCATAGTGTGGTAGAATATCAGCTTACTATTGCTTTACGAA	['AAACTT', 'AGAATA', 'ATAGTG', 'CTGTTA', 'GTTAAA']
AAGTGATACAAGATCGATGACATAGCGTTGAAGAAAAGGATTTGATAATCCGCAAAATTTGCACAACACTGCCTGTAATAC	['AAAATT', 'ACACTG', 'ATAATC', 'GATAAT', 'TAATCC']
GGCACCAGACACCGCATCAACAAAGTTCATTTGTAAAAATGGAGATAATTATGATTGCACATCACTTCGGAACTGATGAAA	['AAAATG', 'AGATAA', 'ATAATT', 'GATAAT', 'GTAAAA', 'TATGAT', 'TTATGA']
CTGACCGCGTTCGAATACACTATTATGGAAACGTTGATACGCAATAATGGCAAAGTGGTCAGCAAAGATTCGTTAATGCTC	['ACACTA', 'ATAATG', 'CGTTAA', 'TAATGC', 'TACACT', 'TATTAT']
ACAATATTTGCCAGGGACTTGTGGTTTTCATTTAGGCGTGGCAATTCTATAATGATACGCATTATCTCAAGAGCAAATTCT	['ACAATA', 'ATAATG', 'CTATAA', 'TATAAT', 'TCTATA']
TATGCTAACTCGCCTCCTTTTCAGAACTTAGCCCCTTCGGGGTGCTGATATACTGGGATGCGATACAGAAATATGAACACG	['ATACTG', 'ATATAC', 'ATATGA', 'ATGCTA']
CAAGATGATCGCAAAACAGACCGTGTTGCGCAATTTGTCAACGAAAACAATAATGCGTAAGGTAGAAACCCGAACTACATT	['ACAATA', 'ATAATG', 'TAAGGT', 'TAATGC']
GCCAATCAAAATAATTGCTACAAATTTGTAACTTTTGCTGTTGTACCTGTACAATGTCCCGGTGTTCAAGTGGCCTTGCCG	['ACAATG', 'ATAATT', 'TAATTG', 'TACAAT']
CTTCCCACGGCGCGCCATTACGCTATTGCAAATGCAAATAGTTATCAATAATATTATCAATATATTTCTGCAATCAATGAA	['ATAGTT', 'TACGCT', 'TATATT', 'TATTAT']
ACCGGAGAAATTGTAAGCATTATTATGCCGACTCTTTTTTATCTTATTTTAAAATGGAATACCGGACATGTTAATTAATCG	['AAAATG', 'ATGTTA', 'TAAAAT', 'TATTAT', 'TTAAAA']
GAACATTGATAATCTGTTCTGAATAACTCAAGTCCGGCGGGTCGCTGCCGATAATACTCTGTAATTGAAGGCTTATAAGGA	['ATAATC', 'ATACTC', 'CGATAA', 'GATAAT', 'TAATCT', 'TAATTG']
CGGTGCTTTACAAAGCAGCAGCAATTGCAGTAAAATTCCGCACCATTTTGAAATAAGCTGGCGTTGATGCCAGCGGCAAAC	['AAAATT', 'GTAAAA', 'TAAAAT', 'TAAGCT']
CACACTTTTCATGAAAATTCTGTAACCGTTTTCACGCGCTATCTGCTAAAAATGTTGCCGATGTGAAGTAAACATGGATGT	['AAAATG', 'AAAATT', 'ACACTT', 'CACACT', 'CTAAAA', 'GCTAAA']
ATAATTCACATCTATATATCTCAGTAATTAATTAATATTTAGTATGAATTTATTCTGAAAATCATTTGTTAATGGCATTTT	['ATAATT', 'TAATTC', 'TAGTAT', 'TATTCT', 'TCTATA']
TTTTCTCTGCCCCTTATTCCCGCTATTAAAAAAAACAATTAAACGTAAACTTTGCGCAATTCAGACCGATAACCCCGGTAT	['AAACTT', 'ACAATT', 'CGATAA', 'TAAACT', 'TTAAAA', 'TTAAAC']
GCATATAGTATCGAACATAGAAAAAACTGAAGATTCATCTTATTTTGTATATACTACCTAGCCCAACAATGTAGAGGTTAA	['ACAATG', 'ATATAC', 'CATATA', 'TAGTAT', 'TGTATA']
CTCCTTGTTCTGCGTCATAGTATGATCGTTAAATAAACGAACGCTGTTCTATAATGTAGAACAAAATGATTCAGCAAGGAG	['AAAATG', 'ATAATG', 'CGTTAA', 'CTATAA', 'GTTAAA', 'TAGTAT', 'TATAAT', 'TATGAT', 'TCTATA']
GCTTCCGGGGTTTTGCCGCGTCGTTAGCACAATGCGATGCAATTGATTTAGTGTATATCTAATAATTGTAAACAAGCACTG	['ACAATG', 'ATAATT', 'CACAAT', 'TAATTG', 'TGTATA']
TCTTTGTATAATCCTGCTAATCTTAATAAAATACAATATCGAAACCCATAGCAAATAATGATTCAACAACGCAACCCATTA	['ACAATA', 'ATAATC', 'ATAATG', 'TAAAAT', 'TAATCC', 'TAATCT', 'TACAAT', 'TATAAT', 'TGTATA']
CACGCTCGCCACAGGCGATTGTCATTACAGGCGGACCGGACCAAATTCCTAAAATCAAACAATACTGGGGTGAACAGCTCA	['ACAATA', 'ATACTG', 'CTAAAA', 'TAAAAT']
ACGCTGGAAAATTTAATTGAAAGCTTTGTGTTACGTGAAGGCACCGATTATGGTGAACATGAGCGTACACTTGAACAGAAA	['AAAATT', 'ACACTT', 'TAATTG', 'TACACT']
TTGCTGTAAAGTATAACGCCTATATTTTACAGTTCAGTCCTCTTTTGCTTATTACAACCTTAAGTATATCAAGCATATAAA	['AGTATA', 'CATATA', 'CCTATA', 'TATATT']
TTTCGCCATTATAGCTAACAGTTAATAAATTGTAGTATGATTTGGTGGCTACATTAGCATGTTTTGCACAACTAGATAACA	['AGATAA', 'TAGCAT', 'TAGTAT', 'TATGAT']
TCAATAGCAGTGTGAAATAACATAATTGAGCAACTGAAAGGGAGTGCCCAATATTACGACATCATCCATCACCCGCGGCAT	['ATAATT', 'CATAAT', 'TAACAT', 'TAATTG']
TTTTATGCTAAAGATTGCAAGTTGCTTGTAAAAGATAAGTACACTGATCCATAATCGCTGTTGTTGAGGGTGCATGCTGCA	['AAGATA', 'ACACTG', 'AGATAA', 'ATAATC', 'ATGCTA', 'CATAAT', 'GCTAAA', 'GTAAAA', 'TACACT']
TCTATTGCTATAAATAAGTGATCTTTTTTCTTTAATTGTTTATTTATTTTAAAATGGTTAAGTTTTGCTAATCATGATGAG	['AAAATG', 'CTATAA', 'TAAAAT', 'TAATTG', 'TTAAAA']
CATTCACATGATTAGCAATAAACGTTGACAAAATGTGGCGTGGATCACTATAATGCCTGCAGATTTTACGTCCCGTCTCGG	['AAAATG', 'ATAATG', 'CTATAA', 'TAATGC', 'TATAAT']
AATCAGATCTTTATAAATCAAAAAGATAAAAAATTGGCACGCAAATTGTATTAACAGTTCAGCAGGACAATCCTGAACGCA	['AAAATT', 'AAGATA', 'ACAATC', 'AGATAA', 'GACAAT']
ATTTTTTGTGCTTTTGCGCAGAAATTTCGCGATATGGCAGGACAAGACGTAAAATTGACAGCAATTTTATTCATATAAAGA	['AAAATT', 'CATATA', 'GTAAAA', 'TAAAAT']
CGATGGTGGATAAATCCTGGACTGGCCTGATTTCTACCGGGATCACCTACAAATTCTGATAATGCATCTTTCCAGGGCATT	['ATAATG', 'GATAAT', 'GGATAA', 'TAATGC']
CCGAAATACTCCTTAGGATGTATAGCGAAAGGAGAAAAAGATATACCTCGATCACCCCCTTTCTCCCAAGTGAAAATAAAA	['AAGATA', 'ATACTC', 'ATATAC', 'TAGGAT', 'TGTATA', 'TTAGGA']
ACACCGTAAAAGTTGCAAAAACGTTAAATGCGTCACACATTTCAATGTTAAAGTGGTCGGCTTTTCCCCTGAAACATGCCA	['ATGTTA', 'CGTTAA', 'GTAAAA', 'GTTAAA']
AAAGAAAATAATTAATTTTACAGCTGTTAAACCAAACGGTTATAACCTGGTCATACGCAGTAGTTCGGACAAGCGGTACAT	['ATAATT', 'CTGTTA', 'GTTAAA', 'TAACCT', 'TTAAAC']
ATTGTGATTGATGTCGGCATCAACCGTCTGGAAAATGGCAAAGTTGTGGGCGACGTCGTGTTTGAAGACGCGGCTAAACGC	['AAAATG', 'CTAAAC', 'GCTAAA', 'GGCTAA']
CGGCAAACAGGGCTTTAATACAGAAACTACTTAGTGTTCAGGAGAGAGACTCAAAAGAAGGGGATAATGCCTGATAATGAG	['ATAATG', 'GATAAT', 'GGATAA', 'TAATGC']
ATAACGTTTCGCTGGCAGGGGATTGTCCGCCACGCATCTTGACGAAAATTAAACTCTCAGGGGATGTTTTCTTATGTCTAC	['AAAATT', 'TAAACT', 'TAACGT', 'TTAAAC']
ACATTACGCTAACGGCACTAAAACCATCACATTTTTCTGTGACTGGCGCTACAATCTTCCAAAGTCACAATTCTCAAAATC	['ACAATC', 'ACAATT', 'CACAAT', 'CGCTAA', 'CTAAAA', 'TACAAT', 'TACGCT']
AAAAGATAAATCCACACAGTTTGTATTGTTTTGTGCAAAAGTTTCACTACGCTTTATTAACAATACTTTCTGGCGACGTGC	['AAGATA', 'ACAATA', 'AGATAA', 'ATACTT', 'TACGCT']
AACGTGATCCACCGCACGCTTTGTCGCCCACCAGGCGGAGCGAATGACTACCCTTAAAGAAAAGCCGATAATTAGCGACGA	['ATAATT', 'CGATAA', 'CTTAAA', 'GATAAT']
GTCTGGAAAAATTCACCGCCACAAACTACCACTAAAAATGTGGTTTTATATTTTTTGCCACCGTGAATATGTAATTAACAG	['AAAATG', 'AAAATT', 'CTAAAA', 'TATATT']
AAACAACACACTAAATATAAAATTATTTCTTGCAGTAATTATAAAAGCCGAAAACAGAACTCAAAAACAATCTGGCTAAAT	['AAAATT', 'ACAATC', 'ACACTA', 'CACACT', 'GCTAAA', 'GGCTAA', 'TAAAAT']
GCAAATTAATAACGAGAGTAATCTCATAACCAAATGCGATAACTCAGACGCTAAAGTTTTGCCACCCGGCTACCGTTATCA	['CGATAA', 'CGCTAA', 'GCTAAA', 'TAATCT']
ATGGCTAACTGGAATTTTTAATTCATGGCAATTAGCGGCAATGGAATATAAAATTCACTCGCGTGTGTCTCATATTGCCTG	['AAAATT', 'GGCTAA', 'TAAAAT', 'TAATTC']
TGCAATAGTCTGTTTTGTCCCTGATTGTTGCTAAAACTCATTTTATTTTAAAAAAATGTTACCTTCATCAATAGTCAACGG	['AAAATG', 'ATGTTA', 'CTAAAA', 'GCTAAA', 'TAGTCT', 'TTAAAA']
GACTGTAAATAGATTAAATTTTGTGGAAATATAATAAGTGATCGCTTACACTACGCGACGAAATACTTTTTTTGTTTTGGC	['ACACTA', 'ATACTT', 'TACACT', 'TAGATT', 'TATAAT']
TTAATTGCTAAAAGCTATAACTGTTAAACACAATACAGTGAAAAGTTTTAGACTGAAGGCTCACTTTGCAGAGGGAAGCGT	['AAGCTA', 'ACAATA', 'AGACTG', 'CACAAT', 'CTAAAA', 'CTATAA', 'CTGTTA', 'GCTAAA', 'GTTAAA', 'TAATTG', 'TAGACT', 'TTAAAC']
TTAAAAAATATGCGCTTATGATTATTTTGTAAGAACACATTCATAATATTCATAATGCTCGTGAATAGTCTTATAAATAAT	['ATAATG', 'CATAAT', 'TAATGC', 'TAGTCT', 'TATGAT', 'TTAAAA', 'TTATGA']
CTTTAGGTAAAAAAAGTTATACGCGGTGGAAACATTGCCCGGATAGTCTATAGTCACTAAGCATTAAAATTTGCGCCTCAT	['AAAATT', 'CTAAGC', 'GGTAAA', 'GTAAAA', 'TAAAAT', 'TAGTCT', 'TCTATA', 'TTAAAA']
TGCTTTTCCATACAAGACCTGATGCTGCCACCCGAGGCTTAACCAGGGTACAATTGCCCGCTAATTAACACCTGCATAAAA	['ACAATT', 'CGCTAA', 'GCTTAA', 'TACAAT']
GCTGTTTTATTGTTCATATAAATCTTAAAAGCAGAAATTTATCTGTTTCCCCCTTTAAAAATTCGGTGAATACCCTTACTT	['AAAATT', 'CATATA', 'CTTAAA', 'TTAAAA']
GCTCCGCAGGATAACCTCTTTTGAATCTGAATGAGTCGATGGCTCGCGAATAATCCGATTACGGCTACGCTTCTAATGTTC	['ATAATC', 'GGATAA', 'TAACCT', 'TAATCC', 'TACGCT']
TTTATCCTTCGCAGGAATAAGGGGGAACTCTCTTTCAGTAATCAGGTATAATTTGTTTAATCAAGCAGCAATTTTGCTGAT	['ATAATT', 'GGTATA', 'TATAAT', 'TATCCT']
CGCTGAAATGTAAAAGTTACAGTCCGCTAAAAATACTTCTGAATTCGCTGTCCAAAGATAAAAACTGCCTGCTGCATTGGG	['AAGATA', 'AGATAA', 'ATACTT', 'CGCTAA', 'CTAAAA', 'GCTAAA', 'GTAAAA']
ATTTGTTATCAATTTATTCTGCGCTAAGGCAACTGCCTGATAAGGTGTTAAAGTTATAAAACCCTTCGCATAAAGGAGTTG	['CGCTAA', 'GCTAAG', 'GTTAAA', 'TAAGGT', 'TATTCT']
AACAACGTTGATATGCGTTGATTCCATTAAAAATCAACATATTACAAAATATCATCAACTATTGATCAAGATAGATTTTCA	['AAGATA', 'TAGATT', 'TATCAT', 'TTAAAA']
ACAAAATCTGAAAATGATGTCAGGCGTTATCTTTTCTTTCTTTAGCGCCTAAAATCGACCTCCCCCCTTTCGTTAAGGATA	['AAAATG', 'CGTTAA', 'CTAAAA', 'TAAAAT']
GATATATGTCAACGAAGCGTAGTTTTATTGGGTGTCCGGCCCCTCTTAGCCTGTTATGTTGCTGTTAAAATGGTTAGGATG	['AAAATG', 'CTGTTA', 'GTTAAA', 'TAAAAT', 'TAGCCT', 'TAGGAT', 'TTAAAA', 'TTAGGA']
TAAATACCCTATCCGAACCTTCTCTTTTGTAACGTTCTAAATATATTCCTAAAAATCTTCAATTCATTGTGACCACAAGTT	['CTAAAA', 'TAACGT', 'TATATT', 'TCTAAA']
CCAGTTTTTAAAAAGTTAATGTTATTAATCTGTTAACATTACGTTATCTAAAATATCTGGTAAAAAGTGGACTAAACGGTC	['ATGTTA', 'CTAAAA', 'CTAAAC', 'CTGTTA', 'GGTAAA', 'GTAAAA', 'TAAAAT', 'TAACAT', 'TAATCT', 'TCTAAA', 'TTAAAA']
TTCTGCGTAAATTGCGAGTATAGACGTTTCTTGCTGGTGGCTAAAATAGTCTCAAAGGGGGGGTATTTTTCTTTGAGCCAG	['AGTATA', 'CTAAAA', 'GAGTAT', 'GCTAAA', 'GGCTAA', 'TAAAAT', 'TAGTCT']
GCTAATTAGCTCGTTGCCTCTTGTTACTATTGTTCATTATTTTGTTTGCTATAATTGTTTGAAAGTTTTGACAGGATTGCC	['ATAATT', 'CTATAA', 'TAATTG', 'TATAAT']
ATATTTTGATCTTCAGAGGCTATTTTATCGATTCAGCTGTAGTAAAATTACGCAAATTTTGACTCTTGAGTATGAGGTTGT	['AAAATT', 'GAGTAT', 'GTAAAA', 'TAAAAT']
GACTGCCCATCTATTGATCCAGAACAGGTAATCAGTATGACGAATACTTAAAATCGTCATACTTATTTCCGCCATCTATTT	['ATACTT', 'CATACT', 'CTTAAA', 'TAAAAT', 'TTAAAA']
AGTAAAAATGCTTTTTATCTGGTTTGTCATGACAGTCAGGCAGAACTGGGTAAAATAGCCGCCTTTCGCCAATGGATCCTG	['AAAATG', 'GGTAAA', 'GTAAAA', 'TAAAAT']
AGTCGCTTCAAATATATGATGCTACTTTTTTAAATGGTTTTTACCTGTCGGCATCCGCTCAAAACGGGCGGTTGTCGATAA	['ATATGA', 'ATGCTA', 'CGATAA', 'TATGAT']
TTTAAATTTACCCCGCTCTGGTGATTCTCAAACGCCAGATGTTACCCGTATCATTCACATGGGTACCAAACATACTCCTGA	['ATACTC', 'ATGTTA', 'CATACT', 'TATCAT']
AGCAAGCATTTTTTGCAAAAAGGGGTAGATGCAATCGGTTACGCTCTGTATAATGCCGCGGCAATATTTATTAACCACTCT	['ATAATG', 'TAATGC', 'TACGCT', 'TATAAT', 'TGTATA']
TTTAGCCTACAGGATTGAGAAAAACTTTTGCTATAGTTTAGTAAAATTTTACCCTAAGGGAGGAAGCAATGGAAACCGTGG	['AAAATT', 'AAACTT', 'ATAGTT', 'GTAAAA', 'TAAAAT', 'TAGCCT']
TTCCAGGCCTGTTTCAAATAATTATTTGCAGTGCAACTAATTCCATGTATATTACTACCCATATATAGCGTCTATAAAATT	['AAAATT', 'ATAATT', 'CATATA', 'CTATAA', 'TAAAAT', 'TAATTC', 'TATATT', 'TCTATA', 'TGTATA']
TAATTCCACAATTGACGGCAACGTCACGTAATAGTTGCGCGGCGTGCTTGTGTTTCCTTAAAGTTAAAACTTTGATACAGA	['AAACTT', 'ACAATT', 'ATAGTT', 'CACAAT', 'CTTAAA', 'GTTAAA', 'TAATTC', 'TTAAAA']
ACCCCGCTATAGTTATGCTATGCATTTGTCTTTAATGATATCTCGTCATTATATTAACAGGATGAAATTATCATTAATGCA	['ATAGTT', 'ATGCTA', 'TAATGC', 'TATATT', 'TATCAT']
CACGAAAAATTCAGAAGCATTACGAAATATGAATTTACAAACAATAGTGGCATAAATGTTAACCATGTTAATTTACGTAAA	['AAAATT', 'ACAATA', 'ATAGTG', 'ATATGA', 'ATGTTA']
AAGACGCGCTAACACGGAACAGGTGCAAAATCGGCGTATTTTGATTACACTCCTGTTAATCCATACAGCAACAGTACTGGG	['CGCTAA', 'CTGTTA', 'TAATCC', 'TACACT']
CCCTATAAAGTAAACGATGACCCTTCGGGAACTTCAGGGTAAAATGACTATCAAAATGTGAATTGTAGCTGACCTGGGACT	['AAAATG', 'CCTATA', 'CTATAA', 'GACTAT', 'GGTAAA', 'GTAAAA', 'TAAAAT']
GTTTGTGTTACCTGTATGAGACGAGAGTTAACCGGACAAGTGTGCCATAATCTCGCGGCCAGGCATACTTGCGAAGATTTC	['ATAATC', 'ATACTT', 'CATAAT', 'CATACT', 'TAATCT']
ATAAAAATTCCCTGAATTAAAAAATCCATTGATATAACTTATATATACAGACAGTAAAATGTTCTGCCACGTTACAATACT	['AAAATG', 'AAAATT', 'ACAATA', 'ATATAC', 'GTAAAA', 'TAAAAT', 'TACAAT', 'TTAAAA']
GATACTAGATGTAGTTGAAAAAAGATTCAACCACACAATATATAGCAAATAGTGGTCGAAATTACCCTGGATATGAGCGTG	['ACAATA', 'ATAGTG', 'ATATGA', 'CACAAT', 'GATACT']
ATTGTAATTTTTCGTAATAATGCGATGAAAACCTGCAAAGAGTGGCTTATAGTTAAGCTAACAAACGAGAGGGCAAGTCCA	['AAGCTA', 'ATAATG', 'ATAGTT', 'TAAGCT', 'TAATGC']
AATTTGATTATTATTTATCATAAAGAAACGTCGCGAGATTATTAAAGAATATCCATTAATGTGCAATTGAAATGTGATAAT	['AGAATA', 'GATAAT', 'TATCAT', 'TATTAT']
TATTCATCAAACGAATGACATTGTTTGAATTCATTAGCAGATAAATAGTGACAATTCCATACGTATTATTAGTTTCAAGAG	['ACAATT', 'AGATAA', 'ATAGTG', 'GACAAT', 'TATTAT']
TGCGCCAACTGTGATAGTGTCATCATTTTCAAAGCGTAAAATTGTGGCATTCTTCACTGTTCTATAAGTAAGACGTTTATT	['AAAATT', 'ATAGTG', 'CTATAA', 'GTAAAA', 'TAAAAT', 'TCTATA']
CTCTTTAAAATCCAGCATTTTTCGCTTCCCGAAGCTGTAACTTTCCTTATACTCGACCTTGCAAACACTTTGTTACATCCT	['ACACTT', 'ATACTC', 'TAAAAT', 'TTAAAA']
CATCTCTTTCCCCTTGACTATCAAGACTTGCCTCACTCCTGCCTGACCGTTAAGCTTTGCGTTTAAACATAAAAACATCAT	['CGTTAA', 'GACTAT', 'TAAGCT', 'TTAAAC']
AGCCAGGCGAGATATGATCTATATCAATTTCTCATCTATAATGCTTTGTTAGTATCTCGTCGCCGACTTAATAAAGAGAGA	['ATAATG', 'ATATGA', 'CTATAA', 'TAATGC', 'TAGTAT', 'TATAAT', 'TATGAT', 'TCTATA']
ATCCGTTGAATGAGTTTTTTTAAAGCTCGTAATTAATGGCTAAAACGAGTAAAGTTCACCGCCGAAAATTGGGCGGTGAAT	['AAAATT', 'CTAAAA', 'GCTAAA', 'GGCTAA']
ATTCGATAAAGCCCGGGCAGCGCAAACTTCGCAGCAGCAGGAATGGAGTACAATGCTGTTAAGTATGCTGCATGATATTCA	['AAACTT', 'ACAATG', 'CGATAA', 'CTGTTA', 'TACAAT']
GTGGCGTCGCTCTTAAACTTATATTGTAAATGACTTAGATTTAAATGAGATAATAATTTTGTTAACAATATGAGGCGGGAG	['AAACTT', 'ACAATA', 'AGATAA', 'ATAATT', 'ATATGA', 'CTTAAA', 'GATAAT', 'TAAACT', 'TAGATT', 'TATATT', 'TTAAAC']
AAGATCGACAATGAAGAAGTGTTGATCATGTCCGAAAGCGACATTCTGGCAATTGTTGAAGCGTAATCCGCGCACGACACT	['ACAATG', 'GACAAT', 'GACACT', 'TAATCC']
CCTTTGTGATAAAAATCACTTTTTTTAAACAATTAAGATAACTGTAATTAACAATCATTTACTATTGCACTGTTAATTGGT	['AAGATA', 'ACAATC', 'ACAATT', 'AGATAA', 'CTGTTA', 'TAATTG', 'TTAAAC']
AATCCCAAGATTAGTCAAAATTTAAACTACCGCCTCTTTATACTCGGATTCACAGCACCTGCGGGTGGCAGTTCGCCGACC	['AAAATT', 'ATACTC', 'TAAACT', 'TTAAAC']
AAAAAACAACGCAGGCTGACAAACGATAAAATTTGCCTTTCACATGAGGTAAATTGCATCAATGGAGTGATTTACATCTAA	['AAAATT', 'CGATAA', 'GGTAAA', 'TAAAAT']
TGGCTTCTGCCACACGTTTAAGCTGCATGAAATTCTCCAGATAATGCTGGTTCTGTATTGGCTTATTTTGCCATAACGAGA	['AGATAA', 'ATAATG', 'GATAAT', 'TAAGCT', 'TAATGC']
ATAAGTGGTCCTCATGTGCATGATGGATTGGAAAATAATTTCTGAAGACTATACTCGCTAATGGAAAAGCAAAGCCGATGA	['AGACTA', 'ATAATT', 'ATACTC', 'CGCTAA', 'CTATAC', 'GACTAT']
CACAAAACAGGCTTGGCGTTATTGCTTTTAATCTCGGTAAACACCACGCCTATGATGTTGGCAGTTTTCTCGATAATTACG	['ATAATT', 'CGATAA', 'GATAAT', 'GGTAAA', 'TAATCT', 'TATGAT']
GCAAAGTCAGGCATTTATACTCTTTTGAATACATAGAAAATTGATATCAATATAATGAAAATATCAAATATTTGCATATAA	['AAAATT', 'ATAATG', 'ATACTC', 'CATATA', 'TATAAT']
AAAGAAAATTCGACCGGGCCGATGATTGAATCTTAACAACAGCGTACGTATGCTAAATATGAGAAATCTCATAGCGGATAA	['AAAATT', 'ATATGA', 'ATGCTA', 'GCTAAA', 'GGATAA']
TAAAATCAAATAGCCTACGCAATGTAGGCTTAATGATTAGTCTGAGTTATATTACGGGGCGTTTTTTTAATGCCCCGCTTT	['GCTTAA', 'TAAAAT', 'TAATGC', 'TAGCCT', 'TAGGCT', 'TAGTCT', 'TATATT']
CCTCAATTTTCCCTTGCTGAAAAATTTTCCATTGTCTCCCCTGTAAAGCTGTGCTTGTATAAATATTGTTAAACACAAAAC	['AAAATT', 'GTTAAA', 'TGTATA', 'TTAAAC']
TTAAATATCAACAAGTTAAAGTATAAAAATCAGCATAAACCCTGATTTTTGTCAAAAAAAATGACGGGGATAACCATATTT	['AAAATG', 'AGTATA', 'GGATAA', 'GTTAAA']
TTAGATGTAATGTGTTTGTCATTGCTTACTTTTTGGCGTTATATGATGGATAATGCCGGGATACAGAGAGACCCGACTCTT	['ATAATG', 'ATATGA', 'GATAAT', 'GGATAA', 'TAATGC', 'TATGAT']
ACCGCCATCCCGGGCAGTAAAAAGACGTAAACTTTCCCAGAATCCTGCCGATATTATCCCACAACTGCTGGATGAACAGAG	['AAACTT', 'GTAAAA', 'TAAACT', 'TATTAT']
GCCTCACACTGACAATGGCTCCAGCTTTTAAGGATGAAGGGGAACTAACCGACATGACAGATATTACAGGCAATCTGACGG	['ACAATG', 'ACACTG', 'CACACT', 'GACAAT']
CATAAATTACACACGGGCAGATAAGCGAAAAATGCCATAATATCCGCACTGTTGCTCAATCAGAAAGGCTTTATATTTAAG	['AAAATG', 'AGATAA', 'CATAAT', 'TATATT']
TATCACTTTTTAGTAAAGTTACACTGGACAAAGCGTACCACAATTGGTGTACTGGTAACCGACACAGCATTTGTGTCTATT	['ACAATT', 'ACACTG', 'CACAAT', 'TACACT']
CGTTGCTAAAATTCTTAGCCATACTGGACAACTCCCCTATGGAGTCATAATCTTAATCAATCATTTGATTAAGAATGGACT	['AAAATT', 'ATAATC', 'ATACTG', 'CATAAT', 'CATACT', 'CTAAAA', 'GCTAAA', 'TAAAAT', 'TAATCT']
CCGGACGGCATAATATTACGACGCTGACCTGGCGGACTGCTGCCGTCAGGTCAATATGCTAAAAATCCCTTCATTTCTAAT	['ATGCTA', 'CATAAT', 'CTAAAA', 'GCTAAA']
AGTATAATTGCAATGTATTTTTTAAGTTTTACTTAATCGATATTTAGATAAACTAATTTTATAAAAAACACAAAATAAAAT	['AGATAA', 'AGTATA', 'ATAATT', 'TAAAAT', 'TAAACT', 'TAATTG', 'TATAAT']
CATTTTGAAACATCTATAGCGATAAATGAAACATCTTAAAAGTTTTAGTATCATATTCGTGTTGGATTATTCTGCATTTTT	['CGATAA', 'CTTAAA', 'TAGTAT', 'TATCAT', 'TATTCT', 'TCTATA', 'TTAAAA']
AACAGGGCGCTCAATGAGTGCCCTGTCTCTTTATTAATATGAAACACTTATACTGGAAACAGGCTGGAATAATCTTAGCCG	['ACACTT', 'ATAATC', 'ATACTG', 'ATATGA', 'TAATCT']
ACTAATAAAATCATAAATCATATGCGTTGAATGGATATTATCCATATAGTGAATTTGTTGATGATGAATTCATCTGTGCTA	['ATAGTG', 'CATATA', 'TAAAAT', 'TATTAT']
GTGGACGTCGCCATTCGCAGGCTCCGCGCAAAAGTTGATGATCCTTTTCCTGAAAAGCTAATTGCCACAATCCGGGGGATG	['AAGCTA', 'ACAATC', 'CACAAT', 'TAATTG']
GAGTTAACCACGCGGCTTGCCAACGGGGTCTGAATCGCTTTTTTTGTATATAATGCGTGTGAAATTTCATACCACAGGCGA	['ATAATG', 'TAATGC', 'TATAAT', 'TGTATA']
TTAATCCCATACTTTTCCACAGGTAGATCCCAACGCGTTCACAGCGTACAATACGCCACTCTTAATAAAGGTGGCGGTTTA	['ACAATA', 'ATACTT', 'CATACT', 'TAATCC', 'TACAAT']
GCGGCATGATATAGCAATTATCGATAATTAACATCCACACATTTTACGCTACATTTGCGCATTAAAAATTATTTGTTATTT	['AAAATT', 'ATAATT', 'CGATAA', 'GATAAT', 'TAACAT', 'TACGCT', 'TTAAAA']
CTTAAAGTTGCATGAAAAATCCCTTTTATCCCCGCGTTAAGCGTCTTAACCTTAAACATGTATATTAAATATAACTTTAAA	['CGTTAA', 'CTTAAA', 'TAACCT', 'TATATT', 'TGTATA', 'TTAAAC']
CACGGGAGTTAGGCCGAAATTTGCTCGTATCTACAATGTAGATTGATATATACTGTATCTACATATGATAGCGGTTTGAGG	['ACAATG', 'ATACTG', 'ATATAC', 'ATATGA', 'TACAAT', 'TAGATT', 'TATGAT']
AAATTAATTGTTATCAAATTGATGTTGTTTTGGCTGAACGGTAGGGTATATTGTCACCACCTGTTGGAATGTTGCGCTAAT	['CGCTAA', 'GGTATA', 'TAATTG', 'TAGGGT', 'TATATT']
CATTACCGCGCGCCTGCTGTTTTTATAAACAATGTATTTTCAATCCGTTATACTTTTCCTGGTGATGTTAGAAAGGAGTAA	['ACAATG', 'ATACTT', 'ATGTTA', 'GTTAGA']
TCCGTGATCGGGGTAAAAAAAAGGTTGCATGAAAACGCGAGCGGAGTATAGTGCGCATCCACGGACGCGGGGTGGAGCAGC	['AGTATA', 'ATAGTG', 'GAGTAT', 'GGTAAA', 'GTAAAA']
ACTTTGGTGGCGCAATTGAAGGTAATGCCAGGCTGTAATCAGGCAAGGATATAATTCCGCAGGAAGCATAGCGTGACTATA	['ATAATT', 'GACTAT', 'TAATGC', 'TAATTC', 'TATAAT']
TCAATAATGTTTCGCCGAATAAATTGTATACTTAAGCTGCTGTTTAATATGCTTTGTAACAATTTAGGCTGAAATTCATAC	['ACAATT', 'ATAATG', 'ATACTT', 'GTATAC', 'TAAGCT', 'TAGGCT', 'TGTATA']
TGTATTGAGCAGTTAAATATTACTTACAAATTTCCGAGTATTCCCAGGAATAATCTTCATGTTCACGCGGCATAATCTCCC	['ATAATC', 'CATAAT', 'GAGTAT', 'GTTAAA', 'TAATCT']
TAAGTGTGATCTACGTCACTCATAACTGCAACGGATAATTTGTTGTTGCATAAAATGTGTGCTCGATCTCATTCATGGCCG	['AAAATG', 'ATAATT', 'GATAAT', 'GGATAA', 'TAAAAT']
AGGCTGTTTACTTTACTAGCAATACGCTTGCGTTCGGTGGTTAAGTATGTATAATGCGCGGGCTTGTCGTAGTTGACAGCA	['ATAATG', 'TAATGC', 'TACGCT', 'TATAAT', 'TGTATA']
ACAGCAGGCGCGCGGTAATGGCTGGATTGCGACACGGAGTTACTTTATAATCCGCTACCATGGCCCCTTAGCTCAGTGGTT	['ATAATC', 'TAATCC', 'TACCAT', 'TATAAT']
GGCCAACTCGCCCTGCTGTTCTTTGGTTAAAGAGTCCCAATACGCTTTCATACAATATGTACCTCCGGTGTACATATTACA	['ACAATA', 'GTTAAA', 'TACAAT', 'TACGCT']
TACATATATTAACCACTTGTTTAATGCGGAGAATCAGTACACTATTTTCTTATAATTACATTTGAAATTATATGATCACCG	['ACACTA', 'ATAATT', 'ATATGA', 'CATATA', 'TAATGC', 'TACACT', 'TATAAT', 'TATATT', 'TATGAT']
GAAATTTATCCTGTTATTATATTGTTTTCAGGTTTTTTTTGGCGCTCCTAATATATGGCTGATTTATAATTGTGAGTTTAA	['ATAATT', 'CTGTTA', 'TAATTG', 'TATAAT', 'TATATT', 'TATCCT', 'TATTAT']
ATCAAAAAAAGTCTATATTTCACTTTGCCCGCGCCGCGAAAGTCACTGATAATGCGCCGCGTTCATGTCCTCAAAATGGCG	['AAAATG', 'ATAATG', 'GATAAT', 'TAATGC', 'TATATT', 'TCTATA']
ATTAAACCTGTGCTCATCCCCGCGGCGTTAACGCGCCGCGTTCCTCTGCTACACTTTCTGAGTGTTTCCGTTAACGAATGA	['ACACTT', 'CGTTAA', 'TACACT', 'TTAAAC']
GCTCACTCATTAGGCACCCCAGGCTTTACACTTTATGCTTCCGGCTCGTATGTTGTGTGGAATTGTGAGCGGATAACAATT	['ACAATT', 'ACACTT', 'GGATAA', 'TACACT']
TACGGCATTGGCACGTCAGAACAAAATCTGAGAGGTGAATCCGTTGAGTATAATTATCTTAGCGACGATTTCGACGACTCA	['AGTATA', 'ATAATT', 'GAGTAT', 'TATAAT']
TTTTAACTTTTAAAGCAGAAATATTGCATAATTATTCTGTCAAAGGTACTATCTTCGACCTCAATAGCTATCAGACTGCCA	['AGACTG', 'ATAATT', 'CATAAT', 'TATTCT']
TTTATCTTCGCTCCTGGCGTTCGGATATTTGCCCGCCGCGTGATTCGCGTTACACTTGCGGCCTTTAGTATCCTGCCGGAG	['ACACTT', 'TACACT', 'TAGTAT', 'TATCCT']
TACCCACTTCTGTGCATACTGTTGAGCTGAAAAACTGACGAATTATGATAAACTCCAGCCAACTTTATTTCATATCATTGA	['ATACTG', 'CATACT', 'TAAACT', 'TATCAT', 'TATGAT', 'TTATGA']
TAGCCAGAAACGCGCCGCGCGTCGTTTGCTTGAACGCGACGCCTGATTTGATACTCCCCCCTGACTCCTTCATACTGAAAG	['ATACTC', 'ATACTG', 'CATACT', 'GATACT']
GTTTAATCAGGGCTATACTTAGCACACTTCCACTGTGTGTGACTGTCTGGTCTGACTGAGACAAGTTTTCAAGGATTCGTA	['ACACTT', 'ATACTT', 'CACACT', 'CTATAC']
GGCTGGTTACAATATGCACTATCAATTTTTTAAATAACAAATTATTAAAACCACATCTGTATAAGGAATTTTTAAGGTTCG	['ACAATA', 'TAAGGT', 'TACAAT', 'TGTATA', 'TTAAAA']
GCGCAGAATAACGTATAGCAAATTAAAAGTATAATTTTTATTTTGTATGTATTATCTTCGATACATTCACCAGACTTATTA	['AGAATA', 'AGTATA', 'ATAATT', 'TAACGT', 'TATAAT', 'TATTAT', 'TTAAAA']
TCTTTAAACTTCTTTACATTAGGTTATGTAAAAACGTATCGGCGTTTATATACTGAAGATAAGCCTGATGAGTAACAGGCT	['AAACTT', 'AAGATA', 'AGATAA', 'ATACTG', 'ATATAC', 'GTAAAA', 'TAAACT', 'TTAAAC']
TAGGTAGAATAGCAATGAACGATTATCCCTATCAAGCATTCTGACTGATAATTGCTCACAGAAACGGAGCGGCACCTCTTT	['AGAATA', 'ATAATT', 'GATAAT', 'TAATTG']
GAAATAAGATCAGCCATTTTTTTATAAACATAAGCTATACGCTGTGCGAAAATATATTCGTGCTGCATTTACTTATTATCA	['AAGCTA', 'CTATAC', 'TAAGCT', 'TACGCT', 'TATATT', 'TATTAT']
TCTGCTGATAACCCTTCCGGTTATATGTTATCTGGTGTGGTTATTCGTTAAACTACAGCGGTTGTCGCGGCGACAAAAGTG	['ATGTTA', 'CGTTAA', 'GTTAAA', 'TAAACT', 'TTAAAC']
TGCACATTACGGGGTTTCTCCGCGTTAAGGATTCATTAAGGTCGCTACGTATACTTCTCGATATCTTATTGATTTGCCTTA	['ATACTT', 'CGTTAA', 'GTATAC', 'TAAGGT']
ATATTCACAAAGATACTCGGTTTAACCTGCCGTTTAATCCGTTTTCACGTAGAATAATGCGCGCTGCGTCTCATGGGAGTG	['AAGATA', 'AGAATA', 'ATAATG', 'ATACTC', 'GATACT', 'TAACCT', 'TAATCC', 'TAATGC']
AATAAAAAACAACATACATATAATAATTTAATCTTAAATGAAATTTATTAAAATTTGCAAACTATAATTTTGTGTATAAAA	['AAAATT', 'ATAATT', 'CATATA', 'CTATAA', 'CTTAAA', 'TAAAAT', 'TAATCT', 'TATAAT', 'TGTATA', 'TTAAAA']
CATTTCAGGGTAATGGGGTGATGAGATGTTGCGTAACAGGGCCAGAAGGCTAGACTACAAAATAATGCGTTGATGATGGAG	['AGACTA', 'ATAATG', 'GCTAGA', 'GGCTAG', 'TAATGC', 'TAGACT']
ATGAACTGATTGAGCATATTGCGACCTTCGCACTTAATTACAAAATTAAGTATAATGAAGACAATAAGCTCATTGAGCAGA	['AAAATT', 'ACAATA', 'AGTATA', 'ATAATG', 'GACAAT', 'TAAGCT', 'TATAAT']
ATTGACTTAGCCCCTTTTTCGGCATTGACTATGTCGTCTGAAAAGGGGCTGAAAAATTTATTTTCACCAACACTTTTTTTG	['AAAATT', 'ACACTT', 'ACTATG', 'GACTAT']
TCGGAGGCTGTTTTTTTATCCATTCGAACTCTTTATACTGGTTACTCCCTACCCAATCGTATTATCAAAATGAAAAAAATT	['AAAATG', 'AAAATT', 'ATACTG', 'TATTAT']
CGGGGCTAAACAGGCGAACGACCTGGATTACGCCAGCCTGCCGGATAGTGTAGTTGAACAGGTTCGCGCTGCGTGGAAGAC	['ATAGTG', 'CTAAAC', 'GCTAAA', 'GGCTAA']
ATGTTTGTCAAATGTTAAATTGAGTTTGCAAAAATGAAAACCCACTGCTAGATTGAAAAAATATTGAACATAAAGGTCATT	['AAAATG', 'ATGTTA', 'GCTAGA', 'GTTAAA', 'TAGATT', 'TGCTAG']
AGGATTAATTAAATTCATTCCTGGCAGGAAAATGGCTTAACATTTGTTAGACTTATGGTTGTCGGCTTCATAGGGAGAATA	['AAAATG', 'AGAATA', 'GCTTAA', 'GTTAGA', 'TAACAT', 'TAGACT']
CATCGCTAATTCCCCGCGCCGTAATTCGCATGCTTTAGTTGTGTATACTCGATCCCGCCCGAAATGTTTTTGGGTAAATCT	['ATACTC', 'CGCTAA', 'GGTAAA', 'GTATAC', 'TAATTC', 'TGTATA']
CAGGGCTATTTACGCCCTGATTGTCTTTTGTTACTTACACAACAATTCATTATTTTTATCACTTATCCTATAGCATTCACG	['ACAATT', 'ATCCTA', 'CCTATA', 'TAGCAT', 'TATCCT']
TTCTCGTGGTTTCGCCGAACTTTCACACTTACGTTCGGTTATGTGCTTAATAATGTTATGAAAAAGAAACCGGTTGCGCAG	['ACACTT', 'ATAATG', 'ATGTTA', 'CACACT', 'GCTTAA', 'TTATGA']
ACCTCTTATGTTTTCTTAAATCAGCATCTTAAAACAGTTAAGAGCATACTATAAATCATTATTTTTCAATGCGTTAGAGAA	['CATACT', 'CTATAA', 'CTTAAA', 'GTTAGA', 'TTAAAA']
CAATTAAATATTCCTGTATCGTTCTTAACGAGCAGTCTGCTTATATTCATATAATCAATGAATATTAATTAATATATAATA	['ATAATC', 'CATATA', 'TATAAT', 'TATATT', 'TATCGT']
CTACTTTTTTATTATTGATGAGTATAAACTTGACGCTTTCAAAATAAAAAGAAAATCGAAGCATTCACACATGAATAAAAA	['AAACTT', 'AGTATA', 'GAGTAT', 'TAAACT', 'TATTAT']
ACTTGACGTGAAAATCATTATCATTTCCTTATGGTTGCAGATAAAACATATTATATTTTTATGTGTTCCATTTTTGCGTAA	['AGATAA', 'TATATT', 'TATCAT', 'TATTAT']
TAACGTGATCATATCAACAGAATCAATAATGTTTCGCCGAATAAATTGTATACTTAAGCTGCTGTTTAATATGCTTTGTAA	['ATAATG', 'ATACTT', 'GTATAC', 'TAACGT', 'TAAGCT', 'TGTATA']
ACACTATTATTGCACTAATTCGCCCTTTGCAATCTATCAATGAGTAGTATAAATACGCTCAGTTACCTTCATTCAATCTAT	['ACACTA', 'AGTATA', 'TAATTC', 'TACGCT', 'TAGTAT', 'TATTAT']
TTTCCCACCATAGCCAACCGCCATAACGGTTGGCTGTTCTTCGTTGCAAATGGCGACCCCCGTCACACTGTCTATACTTAC	['ACACTG', 'ATACTT', 'CACACT', 'CTATAC', 'TCTATA']
TACCTGACGAAGTTGCGTGTTGAAGGCACTATAACACGATGCTAGTATTTGGCAATCAAGACGTTTAGATGTCTAAATAAA	['ATGCTA', 'CTATAA', 'TAGTAT', 'TCTAAA', 'TGCTAG']
AATAAATTCTAACTATATTTTTTTGCCTGTCTGGATCACATAATCCAGATATTTTCCCTGTATGTTAATTGCAGTCATGCT	['ATAATC', 'ATGTTA', 'CATAAT', 'TAATCC', 'TAATTG', 'TATATT']
TGACGCATCGGTGAAAAAGTCAATATTTAATACAGGGCTACTATGCCCGATATCCTTCATACAATGACAATAATATTGCCG	['ACAATA', 'ACAATG', 'ACTATG', 'GACAAT', 'TACAAT', 'TATCCT']
TTATCTTATCGTTTGATTTACATCAAATTGCCTTTAGCTACAGACACTAAGGTGGCAGACATCGAAACGAGTATCAGAGGT	['ACACTA', 'GACACT', 'GAGTAT', 'TAAGGT', 'TATCGT']
TAACCGTAGCAAATTCTGCGGCTCTGGCTATGCTCGAGAAAATTCCATAAAATGCATTTCAAATATACTTTATAAATTAAA	['AAAATG', 'AAAATT', 'ATACTT', 'ATATAC', 'TAAAAT']
CAAAGGCTTGATGCGCGATATGTCCTCCTGACCCATCTCACGTTACAATCCGTGGTTATGTTAAACGCCCTTCTCCGTGTG	['ACAATC', 'ATGTTA', 'GTTAAA', 'TACAAT', 'TTAAAC']
CCGGAATAAAATGCCACAGTGTACGATGTTGTTTCTGTAAGGTGATATTCGTCATAACCCTCTCCTTTAACCGGGCATAAG	['AAAATG', 'TAAAAT', 'TAAGGT', 'TACGAT']
ACGTTGCAGTTATAACCCTTAATGCTAGCGTTACCGTCCGCTATCGTCTATGTTCAAGTTGTCTTAATTGCCAGAATCTAA	['ATGCTA', 'TAATGC', 'TAATTG', 'TATCGT', 'TGCTAG']
AATATTTAGATGAGGATGTGGCAAACGTTTGCTTTTCTCTTTCGGTCAGCTAAAATGCCCGCTTTGCTACCACGGGATTGT	['AAAATG', 'CTAAAA', 'GCTAAA', 'TAAAAT']
TTACAAAACCTGTTGACAGAAAGTTAAAACAGTTTTGTAATGCATGTTACATAATAAATCAAGGAGTCCTTATGGGCGCTT	['ATGTTA', 'CATAAT', 'GTTAAA', 'TAATGC', 'TTAAAA']
CTTACAGTTAACCTGTTGTCGCCTGCTCTGGATTAACGGATAATAGGCGGCTTTTTTATTTCAGGCCGAAAAATGACTGAC	['AAAATG', 'GATAAT', 'GGATAA', 'TAACCT']
CCTTATATGTGGTGCTAATACCCGGTTCAGAGTAGCATGTTTCTACCTTATGATTCGTTAGCTATCTGGAGTTTTAACATG	['TAACAT', 'TAGCAT', 'TATGAT', 'TTATGA']
AAAAATTTTGCGACGAGAATTACGTGACGAAGCGCGCGGCAAAGTGGACAATAAAGCCTGAGCGTTAAGTCAGTCGTCAGA	['AAAATT', 'ACAATA', 'CGTTAA', 'GACAAT']
CTCATTAAAAAATGAGCGATTTTTGACAGTCGTAGAAAATGATAATGCAGAGAATATGCCTTTTCTTTCTTGTTAATTATA	['AAAATG', 'AGAATA', 'ATAATG', 'GATAAT', 'TAATGC', 'TTAAAA']
AAACAGTTCGTAAGGAAAAAGAACCAGACAAATATCAGGGATAAATATTATAATCATGGCGAATGATTTGTTCATGATTAA	['ATAATC', 'GGATAA', 'TATAAT', 'TATTAT']
CAGAAAAAAAGATCAAAAAAATACTTGTGCAAAAAATTGGGATCCCTATAATGCGCCTCCGTTGAGACGACAACGTGAAAC	['AAAATT', 'ATAATG', 'ATACTT', 'CCTATA', 'CTATAA', 'TAATGC', 'TATAAT']
TTCACTGATCCTGATCGTCTTGCCTTATTGAATATGATTGCTATTTGCATTTAAAATCGAGACCTGGTTTTTCTACTGAAA	['ATATGA', 'TAAAAT', 'TATGAT', 'TTAAAA']
AAATGATAGAACTGTGAAACGAAACATATTTTTGTGAGCAATGATTTTTATAATAGGCTCCTCTGTATACGAAATATTTAG	['GTATAC', 'TAGGCT', 'TATAAT', 'TGTATA']
TGGGCTCTCTATTTTAGGATTAATTAAAAAAATAGAGAAATTGCTGTAAGTTGTGGGATTCAGCCGATTTATTATCAATTT	['TAGGAT', 'TATTAT', 'TTAAAA', 'TTAGGA']
GGGCAGGCCTGGGTAAAAATAGGGTGCGTTGAAGATATGCGAGCACCTGTAAAGTGGCGGGGATCACTCCCATAAGCGCTA	['AAGATA', 'GGTAAA', 'GTAAAA', 'TAGGGT']
AGGGAATAACTCGATATAAACTCACCTTTGTAAGGGGGATGTTAAATATATATTAATTCCTGTGTTCCTGATTTTGCCCGG	['ATGTTA', 'GTTAAA', 'TAAACT', 'TAATTC', 'TATATT']
GCCCCTGAGAGTGAGTATCATTTATAATGATAATTCAAACTATCACATAAATAAGATTTATATATAATTTATATTATTCAG	['ATAATG', 'ATAATT', 'GAGTAT', 'GATAAT', 'TAATTC', 'TATAAT', 'TATATT', 'TATCAT', 'TATTAT']
CTTACATTCTGGTTACAGAAAGAGATTGATAATTCGCGTCGCGAAAAATAGTCTGTTCCTGTAGTCAGCGAGACTTTTCTC	['ATAATT', 'GATAAT', 'TAATTC', 'TAGTCT']
AATCTTTCCCCTATCAATATATTAATTAAATCTACATTTACTCATTAGTAAAATTAAATTGAATCAGGGGAGTGAAAACAT	['AAAATT', 'GTAAAA', 'TAAAAT', 'TATATT']
AATTATTCTAATTTTACGCCAGCCTCTTTACTGTATATAAAACCAGTTTATACTGTACACAATAACAGTAATGGTTTTTCA	['ACAATA', 'ATACTG', 'CACAAT', 'TATTCT', 'TGTATA']
TTGCCGAAAGCCGTTAGATTCTGGCAATTAAGACAACTTGAACATAGACGATAGCGGACGGTAACGCTAGCATTAAGGGTT	['CGCTAG', 'GTTAGA', 'TAGATT', 'TAGCAT']
GCTTCAGTGGCGCATTTTGTTGTGTTGTTTGCATATAACCTTCTAAACGTATGGACATCTAAACATCCAAAGAAGGTTTGT	['CATATA', 'CTAAAC', 'TAACCT', 'TCTAAA']
GATACAATGCGATAAAATTGCCCTTGCGAAGGTCATTCGCTTTGGTTAGTATTCACACCCGCTTCAGTGGGAAAGATTAAA	['AAAATT', 'ACAATG', 'CGATAA', 'TAAAAT', 'TACAAT', 'TAGTAT']
TACGGCGAGACGGGAATTTGCTCACTTTTTGACTTTCCGTTACGCAACAGAAAAAGTTAAAAACGAAAAGACTAAAATCAC	['AGACTA', 'CTAAAA', 'GTTAAA', 'TAAAAT', 'TTAAAA']
GGGTGCAACCTGTATCACACCCGATGAAAGATTAATTAGTCAAGATTATGATATCTTTTTAACGGATAATCCGTCTAATCT	['ATAATC', 'GATAAT', 'GGATAA', 'TAATCC', 'TAATCT', 'TATGAT', 'TTATGA']
CCATATCAGACTCCTGAGTGGTTTTTGATTACAAACACCAACAATCTTAGTAAATAACTAATCTAATACCATCAAATAGTT	['ACAATC', 'ATAGTT', 'TAATCT', 'TACCAT']
AAATTCTGCAACTGCGTAAGGCGTTAAATGAAGCTCGCCTTGAGCGAGATATATTAAAAAAAGCAACTGTAGATTCAATTG	['CGTTAA', 'GTTAAA', 'TAGATT', 'TATATT', 'TTAAAA']
TACCTGAAAAGATGAAGATTCTGCATAGCGCGATTTACGCAACAGGAATAGACTGAACACCAGACTCTATAAAAGATGCTA	['AGACTG', 'ATGCTA', 'CTATAA', 'TAGACT', 'TCTATA']
GATCGAAAAACGCTTGTGTTAAAAATTTGCTAAATTTTGCCAATTTGGTAAAACAGTTGCATCACAACAGGAGATAGCAAT	['AAAATT', 'GCTAAA', 'GGTAAA', 'GTAAAA', 'GTTAAA', 'TTAAAA']
GTTTACGGCGAGTTTGTGAAAAGAGCGTTTTTTGATATTTTTTTGTGAGTAAAATTTGTAATGCTTAGACGTTCTTATTCA	['AAAATT', 'GTAAAA', 'TAAAAT', 'TAATGC']
ACCATAATCAGGATGAGCTCCTTTTGACCAATCCCAGGAAAATTCTGCGTATTTTACCGGGTAATTGCGCAATGGACAGTT	['AAAATT', 'ATAATC', 'CATAAT', 'TAATTG']
TTTACAAAAAACACACTAAACTCTTCCTGTCTCCGATAAAAGATGATTAAATGAAAACTCATTTATTTTGCATAAAAATTC	['AAAATT', 'ACACTA', 'CACACT', 'CGATAA', 'CTAAAC', 'TAAACT']
ATCTGGCAGTTTTTGCGCTAAGAAACAGTCTGGCATCATTTCATTAGTATACTGAAATTGAAATAATCGCAGTATGAAATA	['AGTATA', 'ATAATC', 'ATACTG', 'CGCTAA', 'GCTAAG', 'GTATAC', 'TAGTAT']
TCCTATAGCATTCACGAGGATTATCGCTAAACTATGCGGACTTGGAAATTTCCGTCAGTTAGGGTAATGATGAGAGTAGAA	['ACTATG', 'CCTATA', 'CGCTAA', 'CTAAAC', 'GCTAAA', 'TAAACT', 'TAGCAT', 'TAGGGT']
GTGAGCGGCGAATACTAATAACCATTTTCTCTCCTTTTAGTCATTCTTATATTCTAACGTAGTCTTTTCCTTGAAACTTTC	['AAACTT', 'TAACGT', 'TAGTCT', 'TATATT', 'TATTCT']
CTTGCACATAATCACCCTTCGGGTTGTGCTGAACCCAGTAAAGCGGATAAACTCATTACTGAACGGATAATAAAGAGTTGT	['ATAATC', 'CATAAT', 'GATAAT', 'GGATAA', 'TAAACT']
CATCACATCAAATCATTAAACTTGCATTAACTTATTTATAACTTATATTGTCACATGCAAATCAGAATGGTTTCGAATGAA	['AAACTT', 'TAAACT', 'TATATT', 'TTAAAC']
GAAAAGCGCGGTAAATAAGGAAAGAGAATTGACTCCGGAGTGTACAATTATTACAATCCGGCCTCTTTAATCACCCATGGC	['ACAATC', 'ACAATT', 'GGTAAA', 'TACAAT']
AATACCCGGCGTAATGTTAACCGTCTTGCGATAACAGGTCGCTACGAGTAGAATACTGCCGCTTAACGTCGCGTAAATTGT	['AGAATA', 'ATACTG', 'ATGTTA', 'CGATAA', 'GCTTAA', 'TAACGT']
ATAACGCGCAATGGTAAGGTGATGTGCACAGCAAAGCGATGTTAGTGGTATACTTCCGCGCCTGGATGCAGCCGCAGGTGT	['ATACTT', 'ATGGTA', 'ATGTTA', 'GGTATA', 'GTATAC', 'TAAGGT']
CTGAGAGTTTCAGAAAATAACAGCTGAAATAATCTCGCGCAGGACTGTAAATAGATTAAATTTTGTGGAAATATAATAAGT	['ATAATC', 'TAATCT', 'TAGATT', 'TATAAT']
AAAATGTCGTTGCGCGCACAGTACAGCGCAACTTATTTTGTTAAAAACATGTAAATGATTTTTTATTGTGCGCTCAGTATA	['AAAATG', 'AGTATA', 'GTTAAA', 'TTAAAA']
TCTAAAGTGCACAATAGGCGACCTAATGAACAATGGTTGTAAATTTGGGTAACAAATATCATTGCTCATTAATATCTAACA	['ACAATA', 'ACAATG', 'CACAAT', 'TATCAT', 'TCTAAA']
GCAACCTAAATCGATTGCCAGAATTGAAAATTGTAGTGTGAAGACAGTGTATACCCATCGGCGTAATGCTGAGGCCAAGCT	['AAAATT', 'GTATAC', 'TAATGC', 'TGTATA']
TCACATAATATAGATAACAGCATAACAGTTACGCTAATATATTAAATATCAATCTACAGCAATGTTGCTCTCGCCCGGCTT	['AGATAA', 'CATAAT', 'CGCTAA', 'TACGCT', 'TATATT']
CTCCGGTAATTTTTTTAAAAATTTTCTGAACTCTTTCTTCCCAGGCGAGTCTGAGTATATGAAAGACGCGCATTTGTTATC	['AAAATT', 'AGTATA', 'ATATGA', 'GAGTAT', 'TTAAAA']
ATAAAGTCATTTTTTATTCAAATATAAGGAACTTAATATTTAAAAAATGTTCCATACAATTCCTCATCATAAATGACACCG	['AAAATG', 'ACAATT', 'TACAAT', 'TTAAAA']
TTAACAACTCAACCGTTAGTACAGTCAGGAAATAGTTTAGCCTTTTTTAAGCTAAGTAAAGGGCTTTTTCTGCGACTTACG	['AAGCTA', 'ATAGTT', 'GCTAAG', 'TAAGCT', 'TAGCCT']
TACAAAATAATCATAAGCGCATATTTTTTAATGAAAAATCACCTCACCTACAATTAAAAACACGACATCCGCACCATAAAT	['ACAATT', 'ATAATC', 'TACAAT', 'TTAAAA']
CATTTCAGCAGGGTTATTATTTCTATAAACCTGTTACATACATCGACCTGGTCAAAATTATCCTTTCTAAACCGAAGGTGA	['AAAATT', 'CTAAAC', 'CTATAA', 'CTGTTA', 'TATCCT', 'TATTAT', 'TCTAAA', 'TCTATA']
GCAACAAATAGAGCAAAGGGATAAAATAGCAAAAGCGTGATGAAAATGTTATTTTCCGATGCCGCACTGACCCGCTACAAT	['AAAATG', 'ATGTTA', 'GGATAA', 'TAAAAT', 'TACAAT']
CTCTATAATTGGTACTGTGATTTTCTCAGGAAAACCAAGAAGATACAAAATCAAAGCCTAATCAATGTTTATGAACCTGCT	['AAGATA', 'ATAATT', 'CTATAA', 'TAATTG', 'TATAAT', 'TCTATA', 'TTATGA']
TTTATTTTTTATGTATTCTTTTGTGCTTTCAAGATTATGGCGTAAGAAAATTGCAATACGATTATTGTTGTATATTCAAGA	['AAAATT', 'TACGAT', 'TATATT', 'TATTCT', 'TGTATA']
TGCTTTATTCCAAATTTTATTCGTTTAAAAATAAAATGTGCAGCAGGTTATAATTTTGCATTTCGCTATTTCCGCACTTCT	['AAAATG', 'ATAATT', 'TAAAAT', 'TATAAT', 'TTAAAA']
AAAACTGTTATCTATGTATACTTTTAAACCCAATCCGTGTAGAGTCTCTACATAAGATAGTTTGCAGTTGCCGCTTCAGCT	['AAGATA', 'ATACTT', 'ATAGTT', 'CTGTTA', 'GTATAC', 'TAGAGT', 'TGTATA', 'TTAAAC']
TCGCACGGGTGGATAAGCGTTTACAGTTTTCGCAAGCTCGTAAAAGCAGTACAGTGCACCGTAAGAAAATTACAAGTATAC	['AAAATT', 'AGTATA', 'GGATAA', 'GTAAAA', 'GTATAC']
TAAATTTATATTGATTAAATGAATGTATATTTCAAATTGATTTTGTTTGTTATTATTTAAGTGAGGTATATAATTAGAGTC	['ATAATT', 'GGTATA', 'TAGAGT', 'TATAAT', 'TATATT', 'TATTAT', 'TGTATA']
GCACCAGTACAAGCAGCCTGATGTTTGACGAGTATTTAACTTGTTATGAATAACATAGAATAGCAGCCATTCACTTTTTCT	['AGAATA', 'GAGTAT', 'TAACAT', 'TTATGA']
ATATAGCTATTGCTAAAACGTTAATTTTTTGTACCTTCGCAACTCTGGTTTACAATGTGCGCACGAAATGAGAACGCTATG	['ACAATG', 'CGTTAA', 'CTAAAA', 'GCTAAA', 'TACAAT']
GCTAAAGAAACCGTATACGCCGCAGTGGTAAGGTGTGCTTACGTCCCTTATTATTCATAGTGAAAGCATGCCGGATTGCGG	['ATAGTG', 'GCTAAA', 'GTATAC', 'TAAGGT', 'TATTAT']
GAACACAATAAAGATTTAATTCAGCCTTCGTTTAGGTTACCTCTGCTAATATCTTTCTCATTGAGATGAAAATTAAGGTAA	['AAAATT', 'ACAATA', 'CACAAT', 'TAAGGT', 'TAATTC']
CCGACGTCATTATCTCTAACCGAATGGCAGAAGAGCTTAAGGATGTGGCAGATAAGGTATACACCCGCGATCTCTTTGGCA	['AGATAA', 'GCTTAA', 'GGTATA', 'GTATAC', 'TAAGGT']
TTCAAAAATGTTTGTTTTTCACGCGCTTTACAGCCCGAAAAGGCCGGAAGATACTTGCCCGCAACGAAGATTCCTTCATAA	['AAAATG', 'AAGATA', 'ATACTT', 'GATACT']
AAGCATATCTTATTACTAATTGGAATTTGATGTTGCTATATTGAGGTCTATATTAATAATGCCTGTGAATGGTATTTTTGA	['ATAATG', 'ATGGTA', 'TAATGC', 'TAATTG', 'TATATT', 'TCTATA']
TATATTTGCTTGAACGATTCACCGTTTTTTTCATCCGGTTAAATATGCAAAGATAAATGCGCAGAAATGTGTTTCTCAAAC	['AAGATA', 'AGATAA', 'GTTAAA', 'TATATT']
ACACCTGATTCCTCTCTAAATACCCTATCCGAACCTTCTCTTTTGTAACGTTCTAAATATATTCCTAAAAATCTTCAATTC	['CTAAAA', 'TAACGT', 'TATATT', 'TCTAAA']
TCATCTCGTTGATTCCCTTTGTCTGTTTGATAATGCGCACATTGGGTATAACGTGATCATATCAACAGAATCAATAATGTT	['ATAATG', 'GATAAT', 'GGTATA', 'TAACGT', 'TAATGC']
TCATCGCATTAACAATCCAGACCAATTTCAATTGCTGTCATATAACTTTACACTGTCGTTGTTAATTAATCGTTACTAAGA	['ACAATC', 'ACACTG', 'CATATA', 'TACACT']
GTGACAAAGATTTATGCTTTAGACTTGCAAATGAATAATCATCCATATAAATTGAATTTTAATTCATTGAGGCGTTAGCCA	['ATAATC', 'CATATA', 'TAATTC', 'TAGACT']
ATAATATGTAAATAAACCCATCTATAGATGGTAAAAATAGGTTGTGGCAATTATCATTGCATCATTCCCTTTTCGAATGAG	['ATGGTA', 'GGTAAA', 'GTAAAA', 'TATCAT', 'TCTATA']
CGCGATTGCACTCATAAGCTGTTCCGTTTTGAAAATTCGTGTTCAACGATGAATCTGTGGATAATACGCACATTTCGCCGG	['AAAATT', 'GATAAT', 'GGATAA', 'TAAGCT']
GAAACAATTTATAAGGTCAAAGAAATACTATTGCTCAGGTCTATACCGTATACTCCTTTCAGCCACAAAAAAAGTCATGTT	['ACAATT', 'ATACTC', 'CTATAC', 'GTATAC', 'TAAGGT', 'TCTATA']
GATGGTTATTTATTAGTGATATCAACTTGAGGTAAGCGTTAGTTTCGATAAGATAAACTGAGTTACTAATAGTCGAGGCAG	['AAGATA', 'AGATAA', 'CGATAA', 'TAAACT']
CAAATGAAAATAAGCCCTCAACTTTATGACATGACGCGCTTATTAGCTATAATGCGCAACAATTTTCTTAGCGCCTGTCCC	['ACAATT', 'ATAATG', 'CTATAA', 'TAATGC', 'TATAAT', 'TTATGA']
TCTGAAAAACGAAAATCCTCGCTTTATGTCCTTGTTCGATAAACACAATAAACTTGATCATGAAATTGCCAGAAAGGAAGG	['AAACTT', 'ACAATA', 'CACAAT', 'CGATAA', 'TAAACT']
GAAAGATAGGTTCTGATAAAACTTTCTTGTCATCGGCTCCGTTCGCCGTTATGATCGGTCGTCTTTTAAGCAACTATTGAC	['AAACTT', 'AAGATA', 'TATGAT', 'TTATGA']
AAGGGGTAAGAATGGCTATTTTTTCACTGGAGAATTAATAAATCCTCGCTACAATAGACTGAATTTCCCCTGCTTCTTCTT	['ACAATA', 'AGACTG', 'TACAAT', 'TAGACT']
TTATCTTTCCTGTTTACATATAGTTAACGTCACACCTAGTTTATGCTAACTGTCAATAACACAGCAAACGCTATTTGCGCT	['ATAGTT', 'ATGCTA', 'CATATA', 'TAACGT']
ATTGGGTGGGTTGTATATTGACGTTAGTATAAATAGTATTAATGCCGCTTGCATGAATCAAGCAAAATTTATTTATATTAG	['AAAATT', 'AGTATA', 'TAATGC', 'TAGTAT', 'TATATT', 'TGTATA']
ATCGCCCCAGCCGGGGCGATTCAATTTGCTAAACCATGTCGATTACGGATAATGAACAGCATTGCTTATCAGAGATATGCC	['ATAATG', 'CTAAAC', 'GATAAT', 'GCTAAA', 'GGATAA']
TCATTCAATAAAAAGCCTAACTCACTTTTGATTCATTAAAAAAGAAGGCTAAAATAGAATGAATCATCAATCCGCATAAGA	['CTAAAA', 'GCTAAA', 'GGCTAA', 'TAAAAT', 'TTAAAA']
TACGGCCAACAGAGAAAGATACCTGTGCTCACGCCATTGCTTATATTGGCTGGTTACAATATGCACTATCAATTTTTTAAA	['AAGATA', 'ACAATA', 'TACAAT', 'TATATT']
TACGAAAAGTACGGCATTGATAATCATTTTCAATATCATTTAATTAACTATAATGAACCAACTGCTTACGCGGCATTAACA	['ATAATC', 'ATAATG', 'CTATAA', 'GATAAT', 'TATAAT', 'TATCAT']
GGCGCTCTTGCCACCAGCGTGGTATATTTGTCTGCAAGCCATGCCTGGCGTAGACTAATGTCCTTGTTTAAGGAGTAAATA	['AGACTA', 'GGTATA', 'TAGACT', 'TATATT']
CGATGATTAATTGTCAACAGCTCATTTCAGAATATTTGCCAGAACCGTTATGATGTCGGCGCAAAAAACATTATCCAGAAC	['AGAATA', 'TAATTG', 'TATGAT', 'TTATGA']
GATTTCGGGCGTTTAGGAAGATTTGAAATTGTTTTAGCGCAGCGGCAGTTTCATACTATGGCGGTAAAAAAATTTGCATGG	['AAAATT', 'ACTATG', 'CATACT', 'GGTAAA', 'GTAAAA', 'TTAGGA']
TTACCGCATTTTGGAGACTATTATTTACACTAAATCTGATTTGATATATTGATACTTAAAACATTTGATGCTTCCTTTGTC	['ACACTA', 'AGACTA', 'ATACTT', 'CTTAAA', 'GACTAT', 'GATACT', 'TACACT', 'TATATT', 'TATTAT', 'TTAAAA']
TAAATGTAATTTATTATTTACACTTCATTCTTGAATATTTATTGGTATAGTAAGGGGTGTATTGAGATTTTCACTTTAAGT	['ACACTT', 'GGTATA', 'TACACT', 'TATTAT']
TTACCCGTATCATTCACATGGGTACCAAACATACTCCTGACATCTGACTACAATAATTAGTTTTAGTGGGTATCAGTCGTG	['ACAATA', 'ATAATT', 'ATACTC', 'CATACT', 'TACAAT', 'TATCAT']
AGTTTACTTCTATAGTGAGATATTTAATGGCGACATAAAGTAACCAAATAAAATAAGGTTGTCATATGTTACCCAGGATCA	['ATAGTG', 'ATGTTA', 'TAAAAT', 'TAAGGT', 'TCTATA']
GGCGTATACCTATAACGAGCCGGGACGTACGTGGTATATGAGCGTAAACACCCACTTCTGATGCTAACGTCAGATTGTTGA	['ATATGA', 'ATGCTA', 'CCTATA', 'CTATAA', 'GGTATA', 'GTATAC', 'TAACGT']
CGCACTCCCTCTTCCCTTCCGATTTACCTCTCCTTGTTCTGCGTCATAGTATGATCGTTAAATAAACGAACGCTGTTCTAT	['CGTTAA', 'GTTAAA', 'TAGTAT', 'TATGAT']
TTGCAGCATGTCGTTATCATTATTGAACAGATTCATTCATAGAATGAATTGTCAGTTTTGATACGCTAGCGTAGCCTTATA	['CGCTAG', 'TACGCT', 'TAGCCT', 'TATCAT']
CCGGGCTAAATCATTCACATCATCAATTTCATCCTTACTTTCATTCGAAATATAATTTGTGCTCTGCGTCACATTGTTATT	['ATAATT', 'GCTAAA', 'GGCTAA', 'TATAAT']
CTTGTGGCAACAATTTCTACAAAACACTTGATACTGTATGAGCATACAGTATAATTGCTTCAACAGAACATATTGACTATC	['ACAATT', 'ACACTT', 'AGTATA', 'ATAATT', 'ATACTG', 'GACTAT', 'GATACT', 'TAATTG', 'TATAAT']
CATGTCGAACCGGACTGGATCCTGATTTACAAACTTACCGATAAACTTTTACGATTTGAGAGAACTGGAACTCACGCGGCG	['AAACTT', 'CGATAA', 'TAAACT', 'TACGAT']
TGATAACCTTTTATTTTCACTTGGGAGAAAGGGGGTGATCGAGGTATATCTTTTTCTCCTTTCGCTATACATCCTAAGGAG	['ATCCTA', 'CTATAC', 'GGTATA', 'TAACCT']
CACTCCTTGTGGTGGCGAAAAAATATCACAAACTAGAATAGCGCCTTGTATAACAATTCAGCGAGTGAATATTTTGAAAAT	['ACAATT', 'AGAATA', 'CTAGAA', 'TGTATA']
TGGCTAACGCCTCAATGAATTAAAATTCAATTTATATGGATGATTATTCATTTGCAAGTCTAAAGCATAAATCTTTGTCAC	['AAAATT', 'GGCTAA', 'TAAAAT', 'TCTAAA', 'TTAAAA']
TGTGTTAAAAATTTGCTAAATTTTGCCAATTTGGTAAAACAGTTGCATCACAACAGGAGATAGCAATGACGTTACCGAGTG	['AAAATT', 'GCTAAA', 'GGTAAA', 'GTAAAA', 'GTTAAA', 'TTAAAA']
TGGCGCAAAGGGTTAAAAAATTCACATTCTGTACAGCAAGTGACCTGCTACACTGCTTCAACACTACCACTCAGAAGGCAA	['AAAATT', 'ACACTA', 'ACACTG', 'GTTAAA', 'TACACT', 'TTAAAA']
CTGAACCATTGTTAATGCAAATACGTCTGCCTGCAAACTATGGTCGCCGTTATAATGAAGCCTTTAGCGCCATTTACCCCA	['ACTATG', 'ATAATG', 'TAATGC', 'TATAAT']
CGCTTCGCAACCTTTTCGTTGGGTAATTATCAAGCTGGTATGATGAGTTAATATTATGTTAACGGCATGTATATCATTTGG	['ATGTTA', 'TATCAT', 'TATGAT', 'TATTAT', 'TGTATA']
TCTTACGATGTAATTCCATTTATTAAACTTCAAGACATCAGTGCAGAAGAATCAAAAGATATGACAAGAAAAAAAATGCAA	['AAAATG', 'AAACTT', 'AAGATA', 'ATATGA', 'TAAACT', 'TAATTC', 'TACGAT', 'TTAAAC']
TCACTCAATCTATGTAATTAGATTTGACTGAAATCGTACAGTAAAAAGCGTACAATAAAGGCTCCACGAAAGTGGGGCCTT	['ACAATA', 'GTAAAA', 'TACAAT', 'TAGATT']
CCTGAATAATATAAATTATATATAAATCTTATTTATGTGATAGTTTGAATTATCATTATAAATGATACTCACTCTCAGGGG	['ATACTC', 'ATAGTT', 'GATACT', 'TATCAT']
GAACTCCTGTGCAAAAGACAGCAATTTTATTTTCCCTATATTAAGTCAATAATTCCTAACGATGAAGCAAGGGGGTGCCCC	['ATAATT', 'CCTATA', 'TAATTC', 'TATATT']
TTTAACTTATTGATAATAAAGTTAAAAAAACAAATAAATACAAGACAATTGGGGCCAAACTGTCCATATCATAAATAAGTT	['ACAATT', 'GACAAT', 'GATAAT', 'GTTAAA', 'TATCAT', 'TTAAAA']
ATTATATTGTTTTCAGGTTTTTTTTGGCGCTCCTAATATATGGCTGATTTATAATTGTGAGTTTAATATTATGTTGACTCA	['ATAATT', 'TAATTG', 'TATAAT', 'TATATT', 'TATTAT']
CACCAATGAAATCCAGGGCTTTATCTATTACAGCAGGCATATTCTTATCCTTAAAATTAACCATGTTATCGATAAGGCTAT	['AAAATT', 'ATGTTA', 'CGATAA', 'CTTAAA', 'TAAAAT', 'TATCCT', 'TATTCT', 'TTAAAA']
TCGCCATTTGCGACTACACTCCTCGCTGTTGCTTCATGGCACAGCGTTAACGCTATGTACATAGCAGCTAAAAAAATGATG	['AAAATG', 'CGTTAA', 'CTAAAA', 'GCTAAA', 'TACACT']
ATCATACCTATTGAATAAAACAGATTGTTGTCTGGAACAATGTCCCCGATAATATGTAACATATTAGAAACATACCGGCGT	['ACAATG', 'CGATAA', 'GATAAT', 'TAACAT']
CAGAAAAAGATACACAAAATTTATATTTGGAATTTTCTTGTCTCTCCGACAGACTGACCGAATTGTTATCAATGTTAACAA	['AAAATT', 'AAGATA', 'AGACTG', 'ATGTTA', 'TATATT']
ATGTGCATAGCTATGATTCTTGGTCGCCTTGAAATTTATCCTGTTATTATATTGTTTTCAGGTTTTTTTTGGCGCTCCTAA	['CTGTTA', 'TATATT', 'TATCCT', 'TATGAT', 'TATTAT']
AGTACTTCTCTATATTCTTCAGGTAAACTATCAGCTGATGGTTTATCTATACAAAAAAGGAGTCGGGATGAACGAACAATC	['ACAATC', 'CTATAC', 'GGTAAA', 'TAAACT', 'TATATT', 'TATTCT', 'TCTATA']
TAACAAGAATGTTAAAAAACGCTGGACTCAGACAGTAGAGTGTGTGTTATGGTTGACTATAAAGTCAGCGAAGGAAATGCT	['ATGTTA', 'CTATAA', 'GACTAT', 'GTTAAA', 'TAGAGT', 'TTAAAA']
AAAGAAGGCATACTCAGCCTTCTTTTTTTTCACCGTAGTAGAGTGATACAGGAGTCAACAATGGAAATGACCAACGCGCAA	['ACAATG', 'ATACTC', 'CATACT', 'TAGAGT']
AAGCCTGGTATATAACTCTGAATTAATCATCGTTTTGTCGGGAAGCGAGTAAACTTAAAGGATATCTTCAGAGGAGGATAC	['AAACTT', 'CTTAAA', 'GGTATA', 'TAAACT']
TCGTTCAGTGCTGATAACAAACATCAACCTGCAAAACGAAGCGCATAGTTTAAAATGGCTATCATCAATACGCTATATCTG	['AAAATG', 'ATAGTT', 'TAAAAT', 'TACGCT', 'TATCAT', 'TTAAAA']
AAATACCCCCCCTTTGAGACTATTTTAGCCACCAGCAAGAAACGTCTATACTCGCAATTTACGCAGAACTTTTGACGAAAG	['AGACTA', 'ATACTC', 'CTATAC', 'GACTAT', 'TCTATA']
GCAAATGTAGCGTAAAATGTGTGGATGTTAATTATCGATAATTGCTATATCATGCCGCGGATTTTTACTTTCCCATCTCGC	['AAAATG', 'ATAATT', 'ATGTTA', 'CGATAA', 'GATAAT', 'GTAAAA', 'TAAAAT', 'TAATTG', 'TATCAT']
AAGAATAAGATGTAGCGGAGTTGTTTTTGTGTTTACAAACAATGGCTCTACACTGCAAACAGACATAACAACATTCGGGGT	['ACAATG', 'ACACTG', 'AGAATA', 'TACACT']
CATGTTAAAACTCCAGATAGCTAACGAATCATAAGGTAGAAACATGCTACTCTGAACCGGGTATTAGCACCACATATAAGG	['ATGCTA', 'ATGTTA', 'CATATA', 'GTTAAA', 'TAAGGT', 'TTAAAA']
ACCTCGCGCAAAATGCACTAATAAAAACAGGGCTGGCAGGCTAATTCGGGCTTGCCAGCCTTTTTTTGTCTCGCTAAGTTA	['AAAATG', 'CGCTAA', 'GCTAAG', 'GGCTAA', 'TAATTC']
ATTAATACAAAATTCTTATGAATTTAAAAAAAGCACATTGTTTAATGAATACAATGTGCTTTTTATTAGATTAATTTTGAT	['AAAATT', 'ACAATG', 'TACAAT', 'TAGATT', 'TTAAAA', 'TTATGA']
ACGTTTTTCGGCTACACCATTCAGATTATGCAAATAAATATCTCTGAATATAATATATTCATAGCACCCATAATTCATCCT	['ATAATT', 'CATAAT', 'TAATTC', 'TATAAT', 'TATATT']
ATTTGCGTCATGGTGATGAGTATCACGAAAAAATGTTAAACCCTTCGGTAAAGTGTCTTTTTGCTTCTTCTGACTAAACCG	['AAAATG', 'ATGTTA', 'CTAAAC', 'GAGTAT', 'GGTAAA', 'GTTAAA', 'TTAAAC']
GTCGTATTTTCTCGCGCTTTCAGGAAAATCCTTAAAAATGTGACCGATTGGTCAGACGCTGCAGAAGCAGTAAGATAGAAG	['AAAATG', 'AAGATA', 'CTTAAA', 'TTAAAA']
TAAAAGCGTAAACAACTGCCGCTAGGCTTGCTGATCCCGCGCAACAAAACGCCATGCTTTGCTCGCAGATGGTTGGCAACC	['CGCTAG', 'CTAGGC', 'GCTAGG', 'TAGGCT']
TTTATCGTCAAAAAATTGACAGCCGTCACTTTTTAAACAATTGGTGAAATTAAAATGAACGCATCCCAAAATGTTTAAGGA	['AAAATG', 'AAAATT', 'ACAATT', 'TAAAAT', 'TATCGT', 'TTAAAA', 'TTAAAC']
ATTTTTTCTAATGTGGATAGATATGAATTATTTTTCTCCTTAAGGATCATCCGTTATTTGGGTCGTTTTCTGCTAAAATCT	['ATATGA', 'CTAAAA', 'GCTAAA', 'TAAAAT']
CTTCACCGTCACTTCACATAGCTTCAAATTCTTCCCACATAGTCTTCGTATCCTGCTGCCATTGCAAAGGAGAAGACTATG	['ACTATG', 'AGACTA', 'GACTAT', 'TAGTCT', 'TATCCT']
GATCTGGGCCGGTGACTAAGCCGGGAATTGCCTTACAGAAGAATATCCCTGACAATGGTGTTTTAACTTACATTTAACAAT	['ACAATG', 'AGAATA', 'CTAAGC', 'GACAAT']
TTACGTTCTTACACTTTATCTGTGGTTTAAATCGTCCCGGAGTTGCCCTATATTAGCCAAACGTAATTATTTGGTTACAGG	['ACACTT', 'CCTATA', 'TACACT', 'TATATT']
CGGTAAAAGCTTTCCTGCCAGCTGCAACAATGTTGAAAATGCCAGCCAACTGCATGAAGTATGGCAAAAAGGGGCTGATGA	['AAAATG', 'ACAATG', 'GGTAAA', 'GTAAAA']
CGTGCGGGGGCAACCCCGCACACATCAATAATCCCTCCCTTCCCCTGTGCTACACTTCGCGCCATTCCTTACTGCTTAGAG	['ACACTT', 'ATAATC', 'TAATCC', 'TACACT']
CAAATATCAATTAACAATTGATGATTTTGCCAACAGCCCACATAGCGCGATATACTGAAAATTCTCGCAGCAACTGAATGT	['AAAATT', 'ACAATT', 'ATACTG', 'ATATAC']
AAAATCACACGTCTTGTGACCTTCTAAATTGATTCACATGCTAAATCTGATAAGTTTTAATTTCAATGGTAGGTTTATTTC	['ATGCTA', 'ATGGTA', 'GCTAAA', 'TCTAAA']
AAATATGTCTATATGTTAGTAAGTATGATTAAAGAAAAATTTTGACACATTATTATTCGGGCGGTCTTTTGACAGGAGCTA	['AAAATT', 'ATGTTA', 'TATGAT', 'TATTAT', 'TCTATA']
ACTATTCATTCGCGGAATCTGTTAATAAAGCTCGAATTGTGATGACGATCACACATGTTAAAACCTATAATTAATTGCTAC	['ATAATT', 'ATGTTA', 'CCTATA', 'CTATAA', 'CTGTTA', 'GTTAAA', 'TAATTG', 'TATAAT', 'TTAAAA']
CAATAATTATCATTAAAATTCTTCTTGACCGTTTTACTCCAACTCCCTATAGTAGCGCCCCGTTGCCACCCATGAGGTTTG	['AAAATT', 'ATAATT', 'CCTATA', 'TAAAAT', 'TATCAT', 'TTAAAA']
AGGCTTTCTCCAGGGGCGAACAAAGTTTTACATCAACCCGCATTGGTCCTACACTGCGCGGTAATAAAGCGAGGTAAAACA	['ACACTG', 'GGTAAA', 'GTAAAA', 'TACACT']
TTTTAATGCCGTAATTTAATTCATATTGAAGGGTTCTCGTAAAACGTAAATAATTCCTGCGTAGGACTTTTGTTTTGCAGT	['ATAATT', 'GTAAAA', 'TAATGC', 'TAATTC']
TATATATAAATCTTATTTATGTGATAGTTTGAATTATCATTATAAATGATACTCACTCTCAGGGGCGTTGCGGTTTACTAT	['ATACTC', 'ATAGTT', 'GATACT', 'TATCAT']
CTATAACACTGATGTTACCTGCTTAATCCAGCAATACCATGCCTGTCTGCTATGCTTTTTTGATGCGTTTAGCGAAATTTC	['ACACTG', 'ATGTTA', 'CTATAA', 'GCTTAA', 'TAATCC', 'TACCAT']
TTTGCAGATAAATATATATAAATAAAAATCTGTTTTCGCCACATGCTTATTCAAAAAATGAAATAAGAATACATTGCTAAG	['AAAATG', 'AGAATA', 'AGATAA', 'GCTAAG']
CATCAATATTATCCATTTTGCTGTAACATAATTGCTTTAATTGTTAATAATATTTTGCAATCAAGTTATCATAATCAAACA	['ATAATC', 'ATAATT', 'CATAAT', 'TAACAT', 'TAATTG', 'TATCAT', 'TATTAT']
AGCCTCCTGAATAGTGATGCTGAATAACATAACCCCATGATATATCGATAAAATAATCTCTACATTTGAAAATGCACGGTA	['AAAATG', 'ATAATC', 'ATAGTG', 'CGATAA', 'TAAAAT', 'TAACAT', 'TAATCT']
CATCAACCTGCAAAACGAAGCGCATAGTTTAAAATGGCTATCATCAATACGCTATATCTGATGGAAAAAAATATGCCTAAA	['AAAATG', 'ATAGTT', 'TAAAAT', 'TACGCT', 'TATCAT', 'TTAAAA']
CATCACACAATCGTTACATAAAGATTGTTTTTTCATCAGGTTTTACGCTAAATAATCACTGTGTTGAGTGCACAATTTTAG	['ACAATC', 'ACAATT', 'ATAATC', 'CACAAT', 'CGCTAA', 'GCTAAA', 'TACGCT']
TAGTAAACTACTTTGTATGCTGTCTGTCTTTCAAACCGACGCAGCTATTAACGCATGATAATTGAGATTAAGCAAATTTTA	['ATAATT', 'GATAAT', 'TAAACT', 'TAATTG']
AATGGGCATTTCTACACAGATAATGCGATGTTCAGATTCTGTAGACTTATAATGATAGATAATGATCCGTCTACAGCATGA	['AGATAA', 'ATAATG', 'GATAAT', 'TAATGC', 'TAGACT', 'TATAAT']
TCACCACAATCCATTTAAATGAATTTGATAATCATTCTCGTTTGGCATAGCATGAAACATAGCAAAGGCTATGTTTTAGAG	['ACAATC', 'ATAATC', 'CACAAT', 'GATAAT', 'TAGCAT']
ATGAGATAAATCTCCCGTGGCTAACGACATCCCCCGTCGTTGTGTATAGAATATTCCCCCGAAGTTTAAGGTTGGCACCTC	['AGAATA', 'AGATAA', 'GGCTAA', 'TAAGGT', 'TGTATA']
GCCAGCTGAAGAAATCGCTAATTCTTGCAATGTTAGCCACTGGCTAATAGTATTGAGCTGTTAGATAAGAACTCTCTCACT	['AGATAA', 'ATGTTA', 'CGCTAA', 'CTGTTA', 'GGCTAA', 'GTTAGA', 'TAATTC', 'TAGTAT']
TATACCAGAATAATTGAGCATAAACATTTTGACTATGTTGAGACAAAGCATACGGTTGTTACAAAAGAATATCCATTAGAG	['ACTATG', 'AGAATA', 'ATAATT', 'GACTAT', 'TAATTG']
GATGACATAAGCAGGATTTAGCTCACACTTATCGACGGTGAAGTTGCATACTATCGATATATCCACAATTTTAATATGGCC	['ACAATT', 'ACACTT', 'CACAAT', 'CACACT', 'CATACT']
TATTCCGCACACTATTGTGCTGGGCGACCGTAACCTCGACAACGACGATATCGAATATAAATATCGTCGCAACGGCGAGAA	['ACACTA', 'CACACT', 'TAACCT', 'TATCGT']
GGCCGCATCAGCCAGCGAGAATACTTGAACGAAATACCAGGGTATTAGATAATGGCGATTATTATTGGGTTAGAATTTGCC	['AGAATA', 'AGATAA', 'ATAATG', 'ATACTT', 'GATAAT', 'GTTAGA', 'TATTAT']
TGCACGGTTTTATCAAAAGATAAATACCGGGAAATTCCCGCTTACCTATGCTCACAATCAGTCGACTAAAAATGTTTTTGT	['AAAATG', 'AAGATA', 'ACAATC', 'AGATAA', 'CACAAT', 'CTAAAA']
GCAGCATTTCCTCACGATTCTCCTTTGACGATCGCACTTTTTGCTCGTTATGATGGCGTCGCTAGCCTCAGTAAATCCTTA	['CGCTAG', 'TAGCCT', 'TATGAT', 'TTATGA']
TGGGCGATGAATTACGATTTGTCCTGTTGACCTCCGGCGCTACCGTTGCAGACTATAACGACGCACCTGCTGATGCTCAGC	['AGACTA', 'CTATAA', 'GACTAT', 'TACGAT']
TTTTCACCACAAGAATGAATGTTTTCGGCACATTTCTCCCCAGAGTGTTATAATTGCGGTCGCAGAGTTGGTTACGCTCAT	['ATAATT', 'TAATTG', 'TACGCT', 'TATAAT']
AAATTACGGATTATCCTGAAATGCGTTTCTCACTTGCCCGACATATGCGTAAAATGAGCGGCAGATTAAAAAAGGATAGTG	['AAAATG', 'ATAGTG', 'GTAAAA', 'TAAAAT', 'TATCCT', 'TTAAAA']
ATCTTGTAAATTCAGCTAACCCTTGTGGGGCTGCGCTGAAAAGCGACGTACAATGTCGCTAGTATTAATTCATTTCAATCG	['ACAATG', 'CGCTAG', 'TAATTC', 'TACAAT', 'TAGTAT']
AGCGATGTTAAAAACGAAGCGGTGTCGCTGACAAGTGAAGTTGTTTGATTATGATAACTTGATTGCAAAATATTATTAACA	['ATGTTA', 'GTTAAA', 'TATGAT', 'TATTAT', 'TTAAAA', 'TTATGA']
TATTTAACGTTGAATGTTACTGTTGTCGTCAAGATGGCATAAGACCTGCATGAAAGAGCCTGCAAACACACAACACAATAC	['ACAATA', 'ATGTTA', 'CACAAT', 'TAACGT']
GTAATTATAGACAGCTAATTAGCTCGTTGCCTCTTGTTACTATTGTTCATTATTTTGTTTGCTATAATTGTTTGAAAGTTT	['ATAATT', 'CTATAA', 'TAATTG', 'TATAAT']
TTCGCGGGTAGTTATATTATATTTCAATGAATAATAACAACTAACCATTAAAATTATTTCTATATGGGGAAAACCCACTCA	['AAAATT', 'TAAAAT', 'TATATT', 'TATTAT', 'TCTATA', 'TTAAAA']
ATTCGGAATATCCTGCTTATCCTCGTGCTGTTTCTCACGTAGTCTATAATTTCCTTTTTAAGCCCACAGGAGAGCAACAAT	['ATAATT', 'CTATAA', 'TAGTCT', 'TATAAT', 'TATCCT', 'TCTATA']
TAGCTCCCACTTTCCCTTTTCTCCACTTGGCTAAATGTAAAAAAATGGTTAAGACTATGATCAGGTCAGACCACTTTATTT	['AAAATG', 'ACTATG', 'AGACTA', 'GACTAT', 'GCTAAA', 'GGCTAA', 'GTAAAA', 'TATGAT']
TTTAGGTTATTTTCTCTTCATTACACGTATTCTCTTTGCCGGACGTTGCCTATACTCCAGGCAGGAAACTGGAGGATATCT	['ATACTC', 'CCTATA', 'CTATAC', 'TATTCT']
TCAGCAATACATAACCGAGCAGTGTTTAAAGTAAAATCTTAACTACAATATGATTCATTTTGATGATTGTTTCATAAGGAA	['ACAATA', 'ATATGA', 'GTAAAA', 'TAAAAT', 'TACAAT', 'TATGAT']
TTACGAGTATAGCTACGCTTTCTTTAAGTTTTATTTAACCTATGCCCGTTACAATCACCCACCGTAAACAGGCCGCTTGAG	['ACAATC', 'AGTATA', 'GAGTAT', 'TAACCT', 'TACAAT', 'TACGCT']
GTCATACTGACTGCATTAACGCGGTAAATCGAAAAACTATTCTTCGCCGCGCCTGGTTGGGAGTATTTCCCGCTAAAATTG	['AAAATT', 'ATACTG', 'CATACT', 'CGCTAA', 'CTAAAA', 'GAGTAT', 'GCTAAA', 'GGTAAA', 'TAAAAT', 'TATTCT']
ATCCAGTGGTATTATTGGCCATTGAAAGAACCTTTTTACATTATGAGCGTCAATATCAGTGTACCGTTAAATCCGATGATT	['CGTTAA', 'GTTAAA', 'TATTAT', 'TTATGA']
TGCTTTCAAGATTATGGCGTAAGAAAATTGCAATACGATTATTGTTGTATATTCAAGATAATGTGACCTTAATTGTCTTTT	['AAAATT', 'AAGATA', 'AGATAA', 'ATAATG', 'GATAAT', 'TAATTG', 'TACGAT', 'TATATT', 'TGTATA']
ACACTCATCGGGAAAAAAAACATAAATTTAAGCCCAATCGAAAATAATTAAACTTAATCTCGTTTAACCTTTATTGATATG	['AAACTT', 'ATAATT', 'TAAACT', 'TAACCT', 'TAATCT', 'TTAAAC']
TTGTTATCTAGTTGTGCAAAACATGCTAATGTAGCCACCAAATCATACTACAATTTATTAACTGTTAGCTATAATGGCGAA	['ACAATT', 'ATAATG', 'ATGCTA', 'CATACT', 'CTATAA', 'CTGTTA', 'TACAAT', 'TATAAT']
TTTTATGATGCGTTTAATAATTTCAATATAAATTGTTGTTTTTTAAAAATAAAATAGTGAGTGAAAAAAATTCAATTTCAG	['AAAATT', 'ATAATT', 'ATAGTG', 'TAAAAT', 'TATGAT', 'TTAAAA', 'TTATGA']
CACGTCCGGCGGCGCTATTCACGTTGATCTCCTGTGACTCGACGCGGCAGATAATGTAGTATCTCCGGCAATATTGCCCCT	['AGATAA', 'ATAATG', 'GATAAT', 'TAGTAT']
ATTGTGACCACAAGTTTTTCTTCGCTTTTTCGTATGAAGATACTGTCATTAAAATAATAGAAAAGGATTTTACGATGAGCG	['AAGATA', 'ATACTG', 'GATACT', 'TAAAAT', 'TACGAT', 'TTAAAA']
TTGCTACGCATGTCACATTTAACATGGTTGCACAAAGTTGCAACATCATGGATATTTCACGATAACGTTAAGTTGCACCTT	['CGATAA', 'CGTTAA', 'TAACAT', 'TAACGT']
GCAGAATTAAAACCTCGTAAATTGAAATATATATTGATGTAGTGAATGTATCTTAGGTAAATAATATATATTATTTATTTA	['GGTAAA', 'TATATT', 'TATTAT', 'TTAAAA']
AGAGTTCACGCTAATTTAACAAATTTACAGCATCGCAAAGATGAACGCCGTATAATGGGCGCAGATTAAGAGGCTACAATG	['ACAATG', 'ATAATG', 'CGCTAA', 'TACAAT', 'TATAAT']
GCCGTGAGTAAATTAAAATTTTATTGACTTAGGTCACTAAATACTTTAACCAATATAGGCATAGCGCACAGACAGATAAAA	['AAAATT', 'AGATAA', 'ATACTT', 'TAAAAT', 'TTAAAA']
CGCCAGCAGGTGCCAACATTGAACAGTTCATTTTTGCGGGTAAAACAATATACTACCGTAACGGACTTTGTGTGGATGAGA	['ACAATA', 'ATATAC', 'GGTAAA', 'GTAAAA']
AGTTACATTTTAATAATGAGCGTTTTTTGATAGTTTACTTCTATAGTGAGATATTTAATGGCGACATAAAGTAACCAAATA	['ATAATG', 'ATAGTG', 'ATAGTT', 'TCTATA']
GATTTAACCTTTTGAGAACATTTTCCACACCTAAAATGCTATTTCTGCGATAATAGCAACCGTTTCGTGACAGGAATCACG	['AAAATG', 'ATGCTA', 'CGATAA', 'CTAAAA', 'GATAAT', 'TAAAAT', 'TAACCT']
TTTGAAAAAAGATAGAAACATACTTGCAACATTCCAGCTGGTCCGACCTATACTCTCGCCACTGGTCTGATTTCTAAGATG	['AAGATA', 'ATACTC', 'ATACTT', 'CATACT', 'CCTATA', 'CTATAC']
TTCGGCATAGCCAGCATAATCCCGGTACTGTTAGCATATGTTCATCCTTGTAAGTCAAAAGAGAACAATAGCGGATGAATA	['ACAATA', 'ATAATC', 'CATAAT', 'CTGTTA', 'TAATCC', 'TAGCAT']
GCCTTGACCCGAAAGGCGGGAAAGCGCCTGCCGATAAGTTGTGATAAGACAATAATTCACGCGTTAAGGCTAGCGGAATTG	['ACAATA', 'ATAATT', 'CGATAA', 'CGTTAA', 'GACAAT', 'GGCTAG', 'TAATTC']
GCCCTTAAATTCTCTTTTACTTTTGATTTACAGAGTAAAGCGTTGGGATAATCTATCTTCCAAGTAGATTATTGTATTTGA	['ATAATC', 'CTTAAA', 'GATAAT', 'GGATAA', 'TAATCT', 'TAGATT']
TTGGGTGTCCGGCCCCTCTTAGCCTGTTATGTTGCTGTTAAAATGGTTAGGATGACAGCCGTTTTTGACACTGTCGGGTCC	['AAAATG', 'ACACTG', 'CTGTTA', 'GACACT', 'GTTAAA', 'TAAAAT', 'TAGCCT', 'TAGGAT', 'TTAAAA', 'TTAGGA']
TTCCACATAAACCATCGGTATAAACGAAACCATAAAAATGAAATGCTGTTTTCATAAAAAATAAAATTGAAGGTTCATTTT	['AAAATG', 'AAAATT', 'GGTATA', 'TAAAAT']
ATAGACATGTCGGACGAAAATTCGAAGATGTTTACCGTGGAAAAGGGTAAAATAACGGATTAACCCAAGTATAAATGAGCG	['AAAATT', 'AGTATA', 'GGTAAA', 'GTAAAA', 'TAAAAT']
CCCGATAGCAAGGGATTTATCTGGCTTGCAAATGATAAAAATTATCATATGATATTGGTTATCATTATCAATGAAAGAGAT	['AAAATT', 'ATATGA', 'TATCAT', 'TATGAT']
GTCATTTTGATTAATGGTAGCGTCGCTTGTCAATGTAAGTTGTTGATACATAATATTTATATATGATTAATCAACGGATGA	['ATATGA', 'ATGGTA', 'CATAAT', 'TATGAT']
GATTAATCGTCAATTTAAGAGAAAGAGTTACACCGTCACCACTTCCGTGCACTGTATAAAAATCCTATACTGTACGTATCG	['ATACTG', 'ATCCTA', 'CCTATA', 'CTATAC', 'TGTATA']
CTAAAGGTGTCATAATTATTCCCTGAAATAATATATTCATCAAACGAATGACATTGTTTGAATTCATTAGCAGATAAATAG	['AGATAA', 'ATAATT', 'CATAAT', 'TATATT']
TTCGCGCCCTTTGGCTAACACTAAACGTACACTCATAATTTACTTTTCTGTCGATGCAAAGAAATGGGCGTCATTGTCCGG	['ACACTA', 'ATAATT', 'CATAAT', 'CTAAAC', 'GGCTAA', 'TACACT']
GTTAAGAAGCCCATCAGTCTGATAAGGTTAAGATATTCATTCAGTCTATTTATAATATTAACAATCGTTAAGCGTACACTC	['AAGATA', 'ACAATC', 'CGTTAA', 'TAAGGT', 'TACACT', 'TATAAT']
GATTCGGATGTGATGGTATGATTACAGACATTCGTGTCTGAGATTGTCTCTGACTCCATAATTCGAAGGTTACAGTTATGA	['ATAATT', 'ATGGTA', 'CATAAT', 'TAATTC', 'TATGAT', 'TTATGA']
TCAGCTTAAATATATTTCTAGAGAATAAATTTATATTGATTAAATGAATGTATATTTCAAATTGATTTTGTTTGTTATTAT	['AGAATA', 'CTTAAA', 'GCTTAA', 'TATATT', 'TATTAT', 'TGTATA']
ATAACAATCAATAGTACTGGCGTATTTGAAGACAATATAATTATTTCTGGATATTGTTGAGGCTCCCTAATATTTACTTTA	['ACAATA', 'ACAATC', 'ATAATT', 'GACAAT', 'TATAAT']
TATGTAACATAATGCGACCAATAATCGTAATGAATATGAGAAGTGTGATATTATAACATTTCATGACTACTGCAAGACTAA	['AGACTA', 'ATAATC', 'ATAATG', 'ATATGA', 'CATAAT', 'TAACAT', 'TAATGC', 'TATTAT']
TCGTTATATAAATTACCTATAAAAAATAACCATGTATTTATCTTAAATATCAAAACCTTTATAACATCCGAAAAAGAAAGA	['CCTATA', 'CTATAA', 'CTTAAA', 'TAACAT']
ATACAAACTGCATTCGGCTCGCCGCCGGGGGTTGAAACCCTCAAAATCCCCCCCATCTATAATTGCATTATGCCCCGTACT	['ATAATT', 'CTATAA', 'TAATTG', 'TATAAT', 'TCTATA']
TGCCGTGGTGTTTAAACCGCACAGAATAAATTGTCGTGATTTCACCTTTAAAATAAAATTAAAAGAGAAAAAAATTCTCTG	['AAAATT', 'AGAATA', 'TAAAAT', 'TTAAAA', 'TTAAAC']
TCTGACAGTTGAGAAAATGCCGCTGCCTGAAGCTTCGCAACGTTAAGCTGATAAACATTCGACGCATTGCGGTTATGATGA	['AAAATG', 'CGTTAA', 'TAAGCT', 'TATGAT', 'TTATGA']
TTCAATTGCACATTAATGGATATTCTTTAATAATCTCGCGACGTTTCTTTATGATAAATAATAATCAAATTGATAAAATCA	['ATAATC', 'TAAAAT', 'TAATCT', 'TATGAT', 'TATTCT', 'TTATGA']
GAGTCCTAAAAATGGCGGGATAACTTGCCAGAGCGGCTTCCGGGCGAGTAACGTGCTGTTAACAAATAAAGGAGACGTTAT	['AAAATG', 'CTAAAA', 'CTGTTA', 'GGATAA', 'TAACGT']
CGATGTAAATACTTTTATATTTGTTTTCATAATATTTCGCGGGTAGTTATATTATATTTCAATGAATAATAACAACTAACC	['ATACTT', 'CATAAT', 'TATATT', 'TATTAT']
GTCACACTGTACCTGATAAAATCCGATACGCAACTTTATTAGCATGCAAAATCCAAAGTTGCCAGTAAGGCGCTCTTGCCA	['ACACTG', 'CACACT', 'TAAAAT', 'TAGCAT']
TTGTCAAGTGTTACGTTTAGATAATTGCTATCCGGAAAAGCATCTGCTATTTATAGCGGCCTCATTTTTCCCCCGAACATG	['AGATAA', 'ATAATT', 'GATAAT', 'TAATTG']
CGAAAGCCGATTCGGCGACAATTGTCCCGAAATCGCCTCTGGTTCAGGTATACTGACAGACCATTTTTATCTATTTGATTC	['ACAATT', 'ATACTG', 'GACAAT', 'GGTATA', 'GTATAC']
CATCTATCATCTAAAAAACCAGAAAAACAAATAACATCATGTTTTTAAACTAATTAAATGAAATAAAATTTTAAGCCACTC	['AAAATT', 'CTAAAA', 'TAAAAT', 'TAAACT', 'TAACAT', 'TATCAT', 'TCTAAA', 'TTAAAC']
TGCATTTAGCCAACTTAAATTAATGAAAAAATGTTATTAATCGTTGAGCTAAAGTCATTAGAGATGCTTTGCCCTTAATGT	['AAAATG', 'ATGTTA', 'CTTAAA', 'GCTAAA']
TAACGAGCAGTCTGCTTATATTCATATAATCAATGAATATTAATTAATATATAATACATAGGGAATGTAAATGAACAAATT	['ATAATC', 'CATATA', 'TATAAT', 'TATATT']
TGTACATAGCAGCTAAAAAAATGATGAAATAGTCTATCACTTAACTTAATTCACATCACCGCCTGCAAGTATGTGTTATCT	['AAAATG', 'CTAAAA', 'GCTAAA', 'TAATTC', 'TAGTCT']
AATGTGGCATAACAAACTCCAGATAAGTGCTTTTTTATGATTACGCCACATCATAAAAAGAATAAAAAATATCGATTTATG	['AGAATA', 'AGATAA', 'TATGAT', 'TTATGA']
CAGGCACCAGACATAAAATATACTCTTTGTATAATCCTGCTAATCTTAATAAAATACAATATCGAAACCCATAGCAAATAA	['ACAATA', 'ATAATC', 'ATACTC', 'ATATAC', 'TAAAAT', 'TAATCC', 'TAATCT', 'TACAAT', 'TATAAT', 'TGTATA']
ATAATTTATCAGATGATACAGCTATTTCTTACGATGTAATTCCATTTATTAAACTTCAAGACATCAGTGCAGAAGAATCAA	['AAACTT', 'ATAATT', 'TAAACT', 'TAATTC', 'TACGAT', 'TTAAAC']
AGCCCCCACGTCCATTAATAATGCATTTGCATTACCTTAGTTCAAGCTTATAATTTGAGCAGAAAACAGGCTGTAAAAGGA	['ATAATG', 'ATAATT', 'GTAAAA', 'TAATGC', 'TATAAT']
TGGCAGTTCGGGTAGTAATCATAATTCTTGACCTCTCTTTACTTCCTTTTATGGTAAGGGGCTGGACGCTACATTGTTAGC	['ATAATT', 'ATGGTA', 'CATAAT', 'TAATTC']
TAAAAAATGAGCATGATTTTGTTCTGTAGAAAGAAGCAGTTAAGCTAGGCGGATTGAAGATTCGCAGGAGAGCGAGATGGC	['AAAATG', 'AAGCTA', 'CTAGGC', 'GCTAGG', 'TAAGCT']
GGATATAAAATTTAACATTTGGATTGATAATTGTTATCGTTTGCATTATCGTTACGCCGCAATCAAAAAAGGCTGACAAAT	['AAAATT', 'ATAATT', 'GATAAT', 'TAAAAT', 'TAACAT', 'TAATTG', 'TATCGT']
TTTTAAGAATATTATTAATCTGTAATATATCTTTAACAATCTCAGGTTAAAAACTTTCCTGTTTTCAACGGGACTCTCCCG	['AAACTT', 'ACAATC', 'AGAATA', 'GTTAAA', 'TAATCT', 'TATTAT', 'TTAAAA']
CCTTCTCAGGCGGCTTTTTCATCACTGCGAGTAGAGCTAAACTCGCAAAAGTGGTATAACAAATATAGTCTGCCGTATCAT	['CTAAAC', 'GCTAAA', 'GGTATA', 'TAAACT', 'TAGTCT', 'TATCAT']
CATAATTCTTGACCTCTCTTTACTTCCTTTTATGGTAAGGGGCTGGACGCTACATTGTTAGCCAGATATTCTGCCCGGTAT	['ATAATT', 'ATGGTA', 'CATAAT', 'TAATTC', 'TATTCT']
CCGCCCCCGTTATTTTGTGCTATGTTTATTGAATAATGCGCTTTGCTTTTAACTTTTAAAGCAGAAATATTGCATAATTAT	['ATAATG', 'ATAATT', 'CATAAT', 'TAATGC']
TGCGGTTAAAAAGTATACTTTTACACTGGCGAAGAAACGTCGGTGACATACAATTAAAGCATCAACACCAACCGGAACCTC	['ACAATT', 'ACACTG', 'AGTATA', 'ATACTT', 'GTATAC', 'GTTAAA', 'TACAAT', 'TACACT', 'TTAAAA']
TCTATTATCCTGATTCGTAAAGGCCAAACAATAAATTCATTATGATGATAATATTCATGTGATAGTTTGTTTGCGGCGAGA	['ACAATA', 'ATAGTT', 'GATAAT', 'TATCCT', 'TATGAT', 'TATTAT', 'TTATGA']
CCAGCTCTGTGACCTTGTCTTGGTTAACTCAATGTTAAATTGATGTAACATAATCACTTACGTGATGTGCGTGTTTTGCGA	['ATAATC', 'ATGTTA', 'CATAAT', 'GTTAAA', 'TAACAT']
AAAATTTGCCAATGTCGAGCCTGCATGTTGAAGGTGAGAAAGTTTCAAGGAAAAGACTACGTTAGAATATAAGAATGACTA	['AAAATT', 'AGAATA', 'AGACTA', 'GTTAGA']
AAAAGAGTCATCTTGCCTAAGAGTATTGGCAGGATGGTGAGATTGAGCGACAATCGAGTTACACCGTCGCTTAAAGTGACG	['ACAATC', 'CTTAAA', 'GACAAT', 'GAGTAT', 'GCTTAA']
CAAGTAATATTTGTCATAATGCGCGCTGCAATTTATCCGTATTAAGAGAATCAGATGTCCGATAACGCTCAACTTACCGGT	['ATAATG', 'CATAAT', 'CGATAA', 'TAATGC']
TGTGGTGTGCGTTAGCTCGTGTTTTTACACCGCATTCTTGCGCTAACCTTATGATCTGGCAGACAACATGGGAGAGACATC	['CGCTAA', 'TAACCT', 'TATGAT', 'TTATGA']
ATATTTCTTTAGTTGTAATCATATTAAATTTTTTCACTGTTCTGATAGTTAAAATTCAAGACATCAATAAACAATGAGATA	['AAAATT', 'ACAATG', 'ATAGTT', 'GTTAAA', 'TAAAAT', 'TTAAAA']
ATAATCATCATGAATGTTTTGTTTATAATTGGTTGATCCTACTTTCATTATGATTTGCTCATATTTGGTAGAACATGTAAC	['ATAATC', 'ATAATT', 'ATCCTA', 'TAATTG', 'TATAAT', 'TATGAT', 'TTATGA']
GTATACCCTGGCGAAATTGTATAATTTGCCTGCTGATGTTCTGCCTCGTTAAATTTTTTCAGGCCGGATATGGCGTTAACC	['ATAATT', 'CGTTAA', 'GTATAC', 'GTTAAA', 'TATAAT', 'TGTATA']
CAGCTGGAAGTGCATTTGTTAGATGTTGCAATGGACCTTTACGGTCGCCATATACAAGTAGTGCTGCGTAAAAAAATACGC	['ATATAC', 'CATATA', 'GTAAAA', 'GTTAGA']
TACCGTAGCCGGGTAACAGGTAAAGAGTATTAATCCCCGTTTCTGGCGGTATACTGCGACACAATTCCACCTTGAGTAATG	['ACAATT', 'ATACTG', 'CACAAT', 'GAGTAT', 'GGTAAA', 'GGTATA', 'GTATAC', 'TAATCC']
GCCAGCACAATACGATTAAATTAATTAAAACCCCACAAATAAATTAAACATAAGATTTTACTCATTGTGTTTTATTTCTCA	['ACAATA', 'CACAAT', 'TACGAT', 'TTAAAA', 'TTAAAC']
AAGCATATAAGCATGGATAAGCTATTTATACTTTAATAAGTACTTTGTATACTTATTTGCGAACATTCCAGGCCGCGAGCA	['AAGCTA', 'ATACTT', 'CATATA', 'GGATAA', 'GTATAC', 'TAAGCT', 'TGTATA']
ATTATGGCTTTAGAATATTTTTATTTCTAATAGACGAGATTTTTCCTGTTATGATATAATATGCTGAATTAACACATGTTA	['AGAATA', 'ATGTTA', 'CTGTTA', 'TATAAT', 'TATGAT', 'TTATGA']
GGTTTCTACTTTAGGAAGGGATAACTAACGGCTATGGAGTTAAGTATGTAAAATAGCCCGCAGAAAAATATTCACCTTATC	['GGATAA', 'GTAAAA', 'TAAAAT', 'TTAGGA']
GGCACGTAACGCCAACCTTTTGCGGTAGCGGCTTCTGCTAGAATCCGCAATAATTTTACAGTTTGATCGCGCTAAATACTG	['ATAATT', 'ATACTG', 'CGCTAA', 'CTAGAA', 'GCTAAA', 'GCTAGA', 'TGCTAG']
GAATATATTGATAGTGGTTAACCTTCTGGAAAAAAAACAACCTGATCTCCTACACTATCTATAGAGCCGCTCGTATGTTGG	['ACACTA', 'ATAGTG', 'TAACCT', 'TACACT', 'TATATT', 'TCTATA']
CACTGGTTTGGTTAAAAATTAAACACTTGAAAGTGTAATTTCCGTCCCCATATACTAAGCATCAGTAAAAAACTCCCGCCT	['AAAATT', 'ACACTT', 'ATATAC', 'CATATA', 'CTAAGC', 'GTAAAA', 'GTTAAA', 'TTAAAA', 'TTAAAC']
TTTCGTTCTCATTCAGGAAATTTGAACATACCGGGCAGAATATCTGGCTAACAATGTAGCGTCCAGCCCCTTACCATAAAA	['ACAATG', 'AGAATA', 'GGCTAA', 'TACCAT']
TCTTTTTCCCCATTTCCGGCATCGACTCACCACAATGGTCGCAAAATCTGGTAAACTATCATCCAATTTTCTGCCCAAATG	['ACAATG', 'CACAAT', 'GGTAAA', 'TAAACT', 'TATCAT']
TACTTAGGCTGCTAACAAAATTTTGTTGTATGATTGAAATTAGCGGCCTATACTAATTTCGAGTTGTTAAAGCTACGATAA	['AAAATT', 'AAGCTA', 'CCTATA', 'CGATAA', 'CTATAC', 'GTTAAA', 'TACGAT', 'TAGGCT', 'TATGAT']
AGGAAAATGAAGACGAAAACAAGCGAAGACATTCGGCGCGAGTTGGCTATAATACTCGGCACTTGTTTGCCACATATTTTT	['AAAATG', 'ATACTC', 'CTATAA', 'TATAAT']
CCCGCTAAGCTTTTTACGCCTCAAACTTTCGTTTTCGGGCATTTCGTCCAGACTTAAGTTCACAACACCTCACCGGAGCCT	['AAACTT', 'CGCTAA', 'CTAAGC', 'GCTAAG', 'TAAGCT']
CGCTGATGTGGGGGACACAAAAGCGAAAATGCAGAAGAAAGCCATTTGCTAAAATTGAAAGATTACTACTGGGCGCGCAGC	['AAAATG', 'AAAATT', 'CTAAAA', 'GCTAAA', 'TAAAAT']
CCGCCTGAAAGCGGCGGCAAAACTTGCATCGCTGTGCCAGACTGGTTATAAGGTGCGTTTTAACGTAATGGCGGAACACCT	['AAACTT', 'AGACTG', 'TAACGT', 'TAAGGT']
AACCCGGCAGCAGTGATATCAATCTTGAACGTGTCGAAGCGTTAAAACTGGCGATTCGTAACGGTGAACTAAAAATGGACA	['AAAATG', 'CGTTAA', 'CTAAAA', 'GTTAAA', 'TTAAAA']
GCGCTAGCCCGCAAGCTCGGGTTTAACGTTGATATCCAGCTCGAAGAGGGGATCGTTGGGCTTACGCTAAATCTTGCCCAG	['CGCTAA', 'CGCTAG', 'GCTAAA', 'TAACGT', 'TACGCT']
TATTCTATCCAAAAGGGGGTAAAGGTTGCAGGGAGAGCGCCCCGGCACTAGACTACCCGCCTCTTATTTTAGTCTGAGTCA	['AGACTA', 'GGTAAA', 'TAGACT', 'TAGTCT', 'TATTCT']
CCTTGTTCAGTTAGGCGCTATCTGATGGAAAAATAAAACAGAGGCGCTAAGCTTGCCTCCAGAGGTCCTGAATTTTGGGCA	['CGCTAA', 'CTAAGC', 'GCTAAG', 'TAAGCT']
TTCGCGGCGGCGGCCTCTTTTCGGTATACTGTCCTGATACGCTTTTGTGCGCCCCGAATACGGGCCGATTTTTACTTACCG	['ATACTG', 'GGTATA', 'GTATAC', 'TACGCT']
TTAAAAATCTCTTTAATAACAATAAATTAAAAGTTGGCACAAAAAATGCTTAAAGCTGGCATCTCTGTTAAACGGGTAACC	['AAAATG', 'ACAATA', 'CTGTTA', 'CTTAAA', 'GCTTAA', 'GTTAAA', 'TTAAAA', 'TTAAAC']
CCTTGTTTGCTAAGCCTTCGATCTCAAAAGCATTATCAGACTGATACGCTATTATTGAAAGGATATCATTATTATCGTAGA	['AGACTG', 'CTAAGC', 'GCTAAG', 'TACGCT', 'TATCAT', 'TATCGT', 'TATTAT']
CACAAAAGCGAAAATGCAGAAGAAAGCCATTTGCTAAAATTGAAAGATTACTACTGGGCGCGCAGCAATTTCGTGCGCCCC	['AAAATG', 'AAAATT', 'CTAAAA', 'GCTAAA', 'TAAAAT']
AGTATCGATTCACCACGCTAACTTTTTTTGATTATTTTCTGAAAAAAGCAAAATACTACTGCCCGGATGCGATAATTAACC	['ATAATT', 'CGATAA', 'CGCTAA', 'GATAAT']
AACCAGAATTATGTGAAGCTATGCGTTGCTGCCGCTAATCATTAGCGTTATAGTGAATCCGCTTATTCTCAGGGCGGGGCG	['AAGCTA', 'ATAGTG', 'CGCTAA', 'TATTCT']
AATTGCGATCTAAATCAAATTAATCGGTTAAAGATAACCGCAGCGGGGCCGACATAAACTCTGACAAGAAGTTAACAACCA	['AAGATA', 'AGATAA', 'GTTAAA', 'TAAACT', 'TCTAAA']
TTTAATTGTAGGTGAGGTGATTTTTCATTAAAAAATATGCGCTTATGATTATTTTGTAAGAACACATTCATAATATTCATA	['CATAAT', 'TAATTG', 'TATGAT', 'TTAAAA', 'TTATGA']
CGAAATCATAAGAATTGCTAGAGATTTGGAAGCGCCAGTTGACGCTCCGTTAGATTGCTAACGCCAAAATTAGCGCTGAAT	['AAAATT', 'GCTAGA', 'GTTAGA', 'TAGATT', 'TGCTAG']
CGAAAAAACTAACCAAAACTTTGAATGACACTTTTCGGTTTACTGTGGTAGAGTAACCGTGAAGACAAAATTTCTCTGAGA	['AAAATT', 'AAACTT', 'ACACTT', 'GACACT', 'TAGAGT']
TGCATTGGATGAGGCGAATTTCCCACAATCGGGGATAATTACCTCATGGTCTATTAAGCCTGGTGCATGAGCCGTGGAGCG	['ACAATC', 'ATAATT', 'CACAAT', 'GATAAT', 'GGATAA']
AACACCAGATCTTGTAAGGGCAATCCTGTTGCATTGAGCATAAACTTCACAAAGTAGATTCCTTTACGACCGAATATATTG	['AAACTT', 'TAAACT', 'TAGATT', 'TATATT']
CATTTTAAGAGGTGATTTTGATCACGGAATAAAAAGTGATCGTCAGGTTACATATATTTCAGATACGTAAAATTAGGTAAA	['AAAATT', 'CATATA', 'GGTAAA', 'GTAAAA', 'TAAAAT', 'TATATT']
GGTAATTAATTCTTAACATGCTTTTACTAATAATCTCAATTGCTGGCCCTATAATATTGCGCTAGCATTGCTTTCTGGTTG	['ATAATC', 'CCTATA', 'CGCTAG', 'CTATAA', 'TAACAT', 'TAATCT', 'TAATTC', 'TAGCAT', 'TATAAT']
AAATTCATTGTTTTGATAATCGCTGGCAGAAGCATAAACAGAACTATGCCGGAAGGCAAAAGCGCGACACAATAGAGGATT	['ACAATA', 'ACTATG', 'ATAATC', 'CACAAT', 'GATAAT']
GGTTACTGTGATGTGCTTAATGATGCTCAAGTTAAACTCCACGCTTGCCGATAGCCAACCGCAGAATCATGTATTGTGTCC	['GCTTAA', 'GTTAAA', 'TAAACT', 'TTAAAC']
TATCAACTGAAACAGTTAGCGCGGTATTAATTAGCTCAATAATTAGTGTATACTTGATTTTGTGATATGGGTCACGAAACA	['ATAATT', 'ATACTT', 'GTATAC', 'TGTATA']
TCCAAGTAACAGGAATTTAATCATGTTTACAGTAATGTAACCTTCCCGTAAAATGCCCACACACTTTAAACGCCACCAGAT	['AAAATG', 'ACACTT', 'CACACT', 'GTAAAA', 'TAAAAT', 'TAACCT', 'TTAAAC']
ATGCAAAATGGTCAAGAAGTGGTAATTGATAGCGGTAAAAGCGTTAGCCTCACACTGACAATGGCTCCAGCTTTTAAGGAT	['AAAATG', 'ACAATG', 'ACACTG', 'CACACT', 'GACAAT', 'GGTAAA', 'GTAAAA', 'TAATTG', 'TAGCCT']
TGTAATTTTAATTGATAACGATCAATGTTAAGGGCTCAGAATAATCACATTATTTTTTCTCCTAACCATAAAGGATTAGTT	['AGAATA', 'ATAATC', 'ATGTTA', 'TAATTG']
CACCGGTGCCTTTACCATTTCTGGGTTGTATATCTGCATTCAGTTAATTACTCTGCTTAAACCATGAGAGCAGAGAGAAAA	['CTTAAA', 'GCTTAA', 'TACCAT', 'TGTATA', 'TTAAAC']
TCGCTCGCCCTGACGCCAGCAGTGAAACTTTAATTCGCGAAGCCCTACGCGCCGCGTTATGAGGTAAAGGATGATTGAAGC	['AAACTT', 'GGTAAA', 'TAATTC', 'TTATGA']
TGACTGATTCTAACAAAACATTAACACCAACTGGCAAAATTTTGTCCTAAACTTGATCTCGACGAAATGGCTGCACCTAAA	['AAAATT', 'AAACTT', 'CTAAAC', 'TAAACT']
GAGAGACTCAAAAGAAGGGGATAATGCCTGATAATGAGAACTGCTTTAGTAAACTACTTTGTATGCTGTCTGTCTTTCAAA	['ATAATG', 'GATAAT', 'GGATAA', 'TAAACT', 'TAATGC']
CCTTCTCGCAGGCGTTAAAAAATTACCTGACCGAGCACCCTGAAGCGACCGATCCCCGGGATTATTTGCAGTCGGCTAAAT	['AAAATT', 'CGTTAA', 'GCTAAA', 'GGCTAA', 'GTTAAA', 'TTAAAA']
AAACTGGTTTTTGCACACAACGTTAACGATTTGTGGCGTCGGCGCGTATAATGCGCGCGGTTATGTTAACGGTACGCCTGT	['ATAATG', 'ATGTTA', 'CGTTAA', 'TAATGC', 'TATAAT']
AATAGCAGTCATATTTCCTAACTCCTTGACTATACTCCAGAAGATAACCTTACAGACGGCATAATGCGCGGTAGCTCACAA	['AAGATA', 'AGATAA', 'ATAATG', 'ATACTC', 'CATAAT', 'CTATAC', 'GACTAT', 'TAACCT', 'TAATGC']
CATCTGGATGCGTTGGTGGCAGATGAAGATCTGAGCCGTTTTATCCTATAATCGCGTTCAATCATTTTCATCATTGTTTGA	['ATAATC', 'ATCCTA', 'CCTATA', 'CTATAA', 'TATAAT', 'TATCCT']
CATGGGAAGTCTCCATCGTTTTGTCTTGTGTTTAAATACGCTAACACCTAAACTTACTTTTAGTAAGTACGTACAAAAAGG	['AAACTT', 'CGCTAA', 'CTAAAC', 'TAAACT', 'TACGCT']
ATCTGGCAGGATGTTTACAGACCCAGGCTTGTTACAGGCCAGGTTTATCTTAAAATTACGGTAATTCATGACGTACTGATC	['AAAATT', 'CTTAAA', 'TAAAAT', 'TAATTC', 'TTAAAA']
CGCTGTTTGATTCCTGCGTAAAATTTGTCTCGCCGTCGCGTTGCGAGTAGACTTCGTGCCCTTGTCAAAAACTGGAGATTT	['AAAATT', 'GTAAAA', 'TAAAAT', 'TAGACT']
TTGGTAGGTAGAGTATTTGAAAAACGTAATTGATTGCGAATAGCAACAACTAAACAACCAATACACCCGGCCCCTCGCCGG	['CTAAAC', 'GAGTAT', 'TAATTG', 'TAGAGT']
TATTTACACAGGCAATTTAGTCGCGCTTTCAACCCTTACCTCTGTATAGATAAATTTACACTCCCTTTGAAAACAATCCGC	['ACAATC', 'AGATAA', 'TACACT', 'TGTATA']
CAACATTAAAGCCTCATTTCAATCATCATGATAAATATAAAATTAATATATATTTATGCCGTAAATACCAATATACTTAGC	['AAAATT', 'ATACTT', 'ATATAC', 'TAAAAT', 'TATATT']
ATTGAGTAATTTAGCGGCATTGTTAAACGAACTGGACTCTGCCAGTATGACAAATGCCTTCATACTTGATAATTCATGCTT	['ATAATT', 'ATACTT', 'CATACT', 'GATAAT', 'GTTAAA', 'TAATTC', 'TTAAAC']
GCTTTTTTGTTTCTTCTATCTGACTTGCTTTATTCCAAATTTTATTCGTTTAAAAATAAAATGTGCAGCAGGTTATAATTT	['AAAATG', 'ATAATT', 'TAAAAT', 'TATAAT', 'TTAAAA']
TTCAGTGATAATTATCACATTTCAATTGCACATTAATGGATATTCTTTAATAATCTCGCGACGTTTCTTTATGATAAATAA	['ATAATC', 'ATAATT', 'GATAAT', 'TAATCT', 'TATGAT', 'TATTCT', 'TTATGA']
GCCTTTCAATTTTTTCGCTCCTGCCGGGAAATTACACTGTTCCCGGTTTGTCCGTCGGATAATTCAGAGGCGCGCCTTCTG	['ACACTG', 'ATAATT', 'GATAAT', 'GGATAA', 'TAATTC', 'TACACT']
CCTTATACTGAGACTGAGCGTCGATTCACCTGCAAACGGCGCATTTTTAGAATAATCCTGACCTTGTGCGGAAGAGAAAAC	['AGAATA', 'AGACTG', 'ATAATC', 'ATACTG', 'TAATCC']
ATCATTGGCATTCCTGTCGGCATTGCGAACTTTAAAATTGCCGCTATTGCACTATGGCCGGTTGGTCGTCGCGTGGTATCG	['AAAATT', 'ACTATG', 'TAAAAT', 'TTAAAA']
ACCCATTTGCCGTATTAGCCAGCTTAAAGCGTAAGTAATTGGTGCTCCCCGTTGGATCGGGGATAAACCGTAATTGAGGAG	['CTTAAA', 'GCTTAA', 'GGATAA', 'TAATTG']
TATCGTTAAAAAATGATATTTCACTTTGCCCATGCCGTTAAAGTCACTGATAATGCGTCCGTTCGTAAATTCAAAATGGCG	['AAAATG', 'ATAATG', 'CGTTAA', 'GATAAT', 'GTTAAA', 'TAATGC', 'TATCGT', 'TTAAAA']
CCCGTTAGACATCACAAATCGCGAAGAGTTTCCCATTAATTTTTGATATATTTAAAACTTAGGACTTATTTGAATCACATT	['AAACTT', 'GTTAGA', 'TATATT', 'TTAAAA', 'TTAGGA']
AACAGGAAAGTTTTTAACCTGAGATTGTTAAAGATATATTACAGATTAATAATATTCTTAAAATGTGGTAATTTATTAAAT	['AAAATG', 'AAGATA', 'CTTAAA', 'GTTAAA', 'TAAAAT', 'TAACCT', 'TATATT', 'TATTCT', 'TTAAAA']
CTCGCAATCCGGTAATCCATATCATTTTTGCATAGACTCGACATAAATCGATATTTTTTATTCTTTTTATGATGTGGCGTA	['TAATCC', 'TAGACT', 'TATCAT', 'TATGAT', 'TATTCT', 'TTATGA']
GCGCGAGCAGATTTCACGGAATAATTTCACCAGACTTATTCTTAGCTATTATAGTTATAGAGAGCTTACTTCCGTGAATCA	['ATAATT', 'ATAGTT', 'TATTAT', 'TATTCT']
CCGCGGCAAAAGCAGAAACTGTAAAACGCAGCAGTAGCAAACTAAGCTATAAATTGCAGCGCGAACTGGAGCAGCTACCGC	['AAGCTA', 'CTAAGC', 'CTATAA', 'GTAAAA', 'TAAGCT']
GAAATCCACTAGTCTTGTCCGGTATATGACGATTATCAGAGGTTAAGGTGATGATTTCTCGGCGGTGTATCATATTCCAGA	['ATATGA', 'GGTATA', 'TAAGGT', 'TAGTCT', 'TATCAT']
ATTTTCGAACGTGTACATACAAATATGCACAAAAATAATCATAATTATTTTCTGAGATGCATTATGATATGAACACCAATT	['ATAATC', 'ATAATT', 'ATATGA', 'CATAAT', 'TATGAT', 'TTATGA']
ACACAATGAAGAACAGCTTTATATTGCCAGTGCCACCGCCACCTATATGGTAGGTTGAAGACATAAAAGCAGGTAAACTGC	['ACAATG', 'ATGGTA', 'CACAAT', 'CCTATA', 'GGTAAA', 'TAAACT', 'TATATT']
ATGCGCTACGCTTATCAGGCCTACAGGATATCTGGCAACTTATTAAAATTGCATGAACTTGTAGGACGGATAAGGCGTTCA	['AAAATT', 'GGATAA', 'TAAAAT', 'TACGCT', 'TTAAAA']
CGTGAAATCTGTCACTGAAGAAAATTGGCAACTAAAGGTTAAAACCGTTATAACACAGTCACCGGCGCAGAGGAGACAATG	['AAAATT', 'ACAATG', 'GACAAT', 'GTTAAA', 'TTAAAA']
GGCGAACTAAGTCTGGTTGGCACAGTTAACCTTGATATGCGTAGTCTGTGGCTAAATTTCGAGATTACCCTGGCAATCGAC	['GCTAAA', 'GGCTAA', 'TAACCT', 'TAGTCT']
CGATTCACATTTAAACAATTTCAGAATAGACAAAAACTCTGAGTGTAATAATGTAGCCTCGTGTCTTGCGAGGATAAGTGC	['ACAATT', 'AGAATA', 'ATAATG', 'GGATAA', 'TAGCCT', 'TTAAAC']
AAAATAGTAACGTTGTTTTAATCATCTTTGTCTCTTATTGACATCATGTATAGTTATAGGGCGACATAATATCATCAATAT	['ATAGTT', 'CATAAT', 'TAACGT', 'TATCAT', 'TGTATA']
GCTGTTTTCATAAAAAATAAAATTGAAGGTTCATTTTATAAACCAGACATAACGTTCTACGCTTCTGTGCGTTTTTAATTT	['AAAATT', 'TAAAAT', 'TAACGT', 'TACGCT']
ATCTTCTCCTTAAAGCGATTAATAAATCTTAATAGTATTGATTAACAGGCTAAAATTAACGCCTAACACTATTCAGCATAT	['AAAATT', 'ACACTA', 'CTAAAA', 'CTTAAA', 'GCTAAA', 'GGCTAA', 'TAAAAT', 'TAGTAT']
TTGATAAGCAGTTACTTAATTTAAGTGACGATCGCTAAAAACGACTGTCACTGTCCTAATCTTATACGACATCCGAATGAG	['CGCTAA', 'CTAAAA', 'GCTAAA', 'TAATCT']
ACATCCTATCACAGGATTGAAAGTAGGGGAAAATGGCAGGGTTTTCTCTTTGTGCCTCATCATTACCATAATTAACGGAAT	['AAAATG', 'ATAATT', 'ATCCTA', 'CATAAT', 'TACCAT']
ATCGCCGTTTATACCGGTGGGGCATTGCGCCACACTAAGGTAATTCCTTATGCTGGCAATGTCGTGACCAGTGATATCGCT	['ACACTA', 'CACACT', 'TAAGGT', 'TAATTC']
AACAACAGGCAGACAACGCGCGGCTTTCAAACGAGAAAATGTTGAGGGTACCATAATGTATCCAGTGATATTTTTTTTACG	['AAAATG', 'ATAATG', 'CATAAT', 'TACCAT']
GCTATCGGGAATATTAACGACAACTGACGAATAAAATAAAAACACCCTGTATAATAGGAAAGCTTATTTTACAGGGTAAAA	['GGTAAA', 'GTAAAA', 'TAAAAT', 'TATAAT', 'TGTATA']
AATATATCATCGCTCAATTGCTACAGTTAAAATAATTTATCGCGTTATTTGTCTGATTTTGTTTGATTTTTGTTTAATTGG	['ATAATT', 'GTTAAA', 'TAAAAT', 'TAATTG', 'TATCAT', 'TTAAAA']
CACGAATGGCGAGTAATTGCCAGTTGATCCTGGTATCATCAGAGCTTTGCTGCATCTGCTGAAGATAAAAGGCAGAATCAG	['AAGATA', 'AGATAA', 'TAATTG', 'TATCAT']
AAAAATGGCACAGTATAATTTATTCTACAGGTTATATTGGAAGCAAATATTTTAATATTACATATTCAGTGAAGAAATGCG	['AAAATG', 'AGTATA', 'ATAATT', 'TATAAT', 'TATATT', 'TATTCT']
GCGCTGACAAAATATTGCATCAAATGCTTGCGCCGCTTCTGACGATGAGTATAATGCCGGACAATTTGCCGGGAGGATGTA	['ACAATT', 'AGTATA', 'ATAATG', 'GACAAT', 'GAGTAT', 'TAATGC', 'TATAAT']
GCGGGCATTCGTGTTAAAGCAGACTTGAGAAATGAGAAGATTGGCTTTAAAATCCGCGAGCACACTTTGCGTCGCGTCCCA	['ACACTT', 'CACACT', 'GTTAAA', 'TAAAAT', 'TTAAAA']
TTAAGTGGAATTTTTTCTTTACAATCGAAATTGTACTAGTTTGATGGTATGATCGCTATTCTCATGACACCGGCTTTCGCC	['ACAATC', 'ATGGTA', 'TACAAT', 'TATGAT', 'TATTCT']
CAATTTTCTGACGTGATCTTCATCACAAATAATGACAGTTAAAACCGCTTAAATGCTTCCGAGGTGTCTACCTGACCAGTG	['ATAATG', 'CTTAAA', 'GCTTAA', 'GTTAAA', 'TTAAAA']
GGCGGACCGGACCAAATTCCTAAAATCAAACAATACTGGGGTGAACAGCTCAAAATTCCCGTTATTCCTCTCACGAGTGAC	['AAAATT', 'ACAATA', 'ATACTG', 'CTAAAA', 'TAAAAT']
CATAGTTAGCTAATGCTAAATCGTATTGACTATGTTTTTGTTAACATCTATCTTGTTAGTTATGACTAACAATAAAGGTGT	['ACAATA', 'ACTATG', 'ATAGTT', 'ATGCTA', 'GACTAT', 'GCTAAA', 'TAACAT', 'TAATGC', 'TTATGA']
TGAGCAATTATCAGTCAGAATGCTTGATAGGGATAATCGTTCATTGCTATTCTACCTATCGCCATGAACTATCGTGGCGAT	['ATAATC', 'GATAAT', 'GGATAA', 'TATCGT', 'TATTCT']
TGTCACGTTTACCTTACGAGCCCAAACTTAAATAAAACTTATACAGAGTTACACTTTCTTACATAACGCCTGCTAAATTAT	['AAACTT', 'ACACTT', 'CTTAAA', 'GCTAAA', 'TACACT']
GACCCGGCCTGACTGAATATCTCACGTTTTCCTGCTTAACATTCATGTTATGATGCTCTTGAAACTAATAATACGTATGGA	['ATGTTA', 'GCTTAA', 'TAACAT', 'TATGAT', 'TTATGA']
AACTAAACCGTGGCACAAATGGGCAATTTATCCATCGGTAAAATACTATAAAATAGCTTTAGAAAATTCCCCCTGGAAAGA	['AAAATT', 'CTAAAC', 'CTATAA', 'GGTAAA', 'GTAAAA', 'TAAAAT']
CATAATTGATTATTTGACGTGGTTTGATGGCCTCCACGCACGTTGTGATATGTAGATGATAATCATTATCACTTTACGGGT	['ATAATC', 'ATAATT', 'CATAAT', 'GATAAT', 'TAATTG']
CAGTTTGCTATAAAGGTGTTGCCCGAACTCATAAAAATTAACAAAATTTGTCGTTCCGCCATCGGCTAATCGCATTAAGGT	['AAAATT', 'CTATAA', 'GGCTAA', 'TAAGGT']
TACTTATACGGCAACGATTGCGTTGCGCAAATCGGCTCTACGAAAACGTTAAACTGATTAAAAAGGAAAGGCATGTCCCGG	['CGTTAA', 'GTTAAA', 'TAAACT', 'TTAAAA', 'TTAAAC']
CCGGCTTTTATCATTATGTTGATGAATGAATAATTTACTAATGTTTATTTAAAATATTTCAATGTCGTTATATAAATTACC	['ATAATT', 'TAAAAT', 'TATCAT', 'TTAAAA']
ATTATTCTTTATGTTGGGTCTATTAAGGTTATGTTAATTGTAGCTTTGCTATGCTAGTAGTAGATTTTTGATAAATGTTTT	['ATGCTA', 'ATGTTA', 'TAAGGT', 'TAATTG', 'TAGATT', 'TATTCT', 'TGCTAG']
GTGCAAGCAAAGTTGCTACTTTGGACATTAACAGCTTCAATAATGGTAATAATCTTATCTGAGGAGGGCGAAGTGGCGGAG	['ATAATC', 'ATAATG', 'ATGGTA', 'TAATCT']
ATAAAAAGGTGGTTCATAGTAAACGTGAAAATCATTCTGCTGGCGAGAGATATAATTGCACTTGATTGTTAAAAAAATGTT	['AAAATG', 'ATAATT', 'GTTAAA', 'TAATTG', 'TATAAT', 'TTAAAA']
CAAAGCGAGAAAAAATACCCATAATGTTGTCCTCTTGATTTCTGCGTTCAGGATTGTCCTGCTGAACTGTTAATACAATTT	['ACAATT', 'ATAATG', 'CATAAT', 'CTGTTA', 'TACAAT']
AATTAAAAATGTGAACTCCGTCATTACACAAAAAGTGTCATCTGGCGTTACACTTTATGCGGATACTAAAACAGGAGGTTT	['AAAATG', 'ACACTT', 'CTAAAA', 'GATACT', 'TACACT', 'TTAAAA']
TGGGTAAAACTTTGTCGCGGGAATGATGACAAATCCCAGGGAAAAAGAAACAATAGCAATATCCCGTATGAATATAATAAA	['AAACTT', 'ACAATA', 'GGTAAA', 'GTAAAA', 'TATAAT']
CCATGATAATGAAATTAATTATCGTTATCGATCTTATTTGGATATGTTAGCATGTGCAGCCTAAGAATAGGTATTTAAAAT	['AGAATA', 'ATAATG', 'ATGTTA', 'GATAAT', 'TAAAAT', 'TAGCAT', 'TATCGT', 'TTAAAA']
CGCGTTAAATGCTGAATCTTTACGCATTTCTCAAACCCTGAAATCACTGTATACTTTACCAGTGTTGAGAGGTGAGCAATG	['ATACTT', 'CGTTAA', 'GTATAC', 'GTTAAA', 'TGTATA']
TCTATACTGTTTCACAGACCTGCTGCCCTGCGGGGCGGCCATCTTCCTTTATTCGCTTATAAGCGTGGAGAATTAAAATGC	['AAAATG', 'ATACTG', 'CTATAC', 'TAAAAT', 'TCTATA', 'TTAAAA']
GCACTTGCTTACATAACAATATACAATTGCTCGTTGAAAGAGTGAGCTAAAATCCCTATAACAGTAGAACCCTCCCGAGTG	['ACAATA', 'ACAATT', 'ATATAC', 'CCTATA', 'CTAAAA', 'CTATAA', 'GCTAAA', 'TAAAAT', 'TACAAT']
TGTTTTGTAGGTAAGGTGTTATGTTGCCTTGTCGTACCATTATCAACACGATAATAATTAATAATTCATTTTTAAATAAAT	['ATAATT', 'CGATAA', 'GATAAT', 'TAAGGT', 'TAATTC', 'TACCAT']
TTTATAAAAAATAAATCTCGACAATTGGATTCACCACGTTTATTAGTTGTATGATGCAACTAGTTGGATTATTAAAATAAT	['ACAATT', 'GACAAT', 'TAAAAT', 'TATGAT', 'TTAAAA']
TTACGCTGTATCAGAAATATTATGGTGATGAACTGTTTTTTTATCCAGTATAATTTGTTGGCATAATTAAGTACGACGAGT	['AGTATA', 'ATAATT', 'CATAAT', 'TACGCT', 'TATAAT', 'TATTAT']
AACCAGAGTTGCGAAGGTACAAAAAATTAACGTTTTAGCAATAGCTATATAATATAGCCTGTGCTATATCTGTATGTAATG	['AAAATT', 'TAACGT', 'TAGCCT', 'TATAAT']
GACCGCCGGACGGCTAAAATAAAATTTGCTTAATCTCAATTATCATGCGTTAATAGCTGCGTCGGTTTGAAAGACAGACAG	['AAAATT', 'CGTTAA', 'CTAAAA', 'GCTAAA', 'GCTTAA', 'GGCTAA', 'TAAAAT', 'TAATCT', 'TATCAT']
GTGTTTATGTATGTCGGATATCTGGTGGTGAAATACTTTATGCCATGATAATTTAATACGATGTATTTATTATATGGAGCA	['ATAATT', 'ATACTT', 'GATAAT', 'TACGAT', 'TATTAT']
CGACAAACTATATGTAGGTTAATTGTAATGATTTTGTGAACAGCCTATACTGCCGCCAGGTCTCCGGAACACCCTGCAATC	['ATACTG', 'CCTATA', 'CTATAC', 'TAATTG']
ATCGCAGACTACAAAGCCTGCGGATTGACAATCTTATCGTGAAGGCATACTTTCAGGAGTGAGGGTAGAGCGGGGTTTCCC	['ACAATC', 'AGACTA', 'ATACTT', 'CATACT', 'GACAAT', 'TATCGT']
TACAAACGAGGCTGTACCTTACCGTTTTTATTGTTATGTTGAATCAAGCTAAAATGACAAATTATCGCTAAGTTCGGACAA	['AAAATG', 'AAGCTA', 'CGCTAA', 'CTAAAA', 'GCTAAA', 'GCTAAG', 'TAAAAT']
TTTTTTGATTTGCCCCCTGTATGGATTTCACTCAAAAAATAATTATCTTATATAATTCAGGCAAATACTTCCTTTTAGTAA	['ATAATT', 'ATACTT', 'TAATTC', 'TATAAT']
TATTATGATGTTTTTTTACTCGGCGCTTGATTCACCTTGTTACAGATTGCTATTGTGTGCGCGCGTCGAATGACCGTTAAT	['CGTTAA', 'TATGAT', 'TATTAT', 'TTATGA']
GAGTAACGTATTATGTCAGAAGAAAATAAAGAAAATGGATTTAATCATGTCAAAACATTCACCAAAATTATATTTATTTTT	['AAAATG', 'AAAATT', 'TAACGT', 'TATATT', 'TATTAT']
CTGAAAACCGAAAAATGCCACAATATTGGCTGTTTATACAGTATTTCAGGTTTTCTCATGGCATTAACCGCCGCGCTTAAA	['AAAATG', 'ACAATA', 'CACAAT', 'CTTAAA', 'GCTTAA']
GAAAAAACACGTAAAATAGCGCTCAACAATGCCACGGATTGCGTGGCATTATTATTTTCAGGAGGAACAATGTCTCAGGTT	['ACAATG', 'GTAAAA', 'TAAAAT', 'TATTAT']
AGGTGTATGTCATAAGATAAAATGTTAACTATGTATTCCTCGCGGTAAATAATATGAGGTAAAATATGAAAATTGGAACTG	['AAAATG', 'AAAATT', 'AAGATA', 'ACTATG', 'AGATAA', 'ATATGA', 'ATGTTA', 'GGTAAA', 'GTAAAA', 'TAAAAT']
ATCAGGTTAAAACCTGATTTTCTCCTTTCTAAGCCGCTACAGATTGGTTAGCATATTCACCTTTAATCGCGCATGATCGAA	['CTAAGC', 'GTTAAA', 'TAGCAT', 'TTAAAA']
CAGAGTGCAAGTGGGCTTTGGCGTGTGGCAATTCTTAAAACATTGTCTAACATGCTTGTTACCGTCATTATCATCCGTGGT	['CTTAAA', 'TAACAT', 'TATCAT', 'TTAAAA']
CAAAACCTCATGTATGCTACGCAGAAGTTATCAAGTACCTCGTAGCGTATATACTTCTTAAACAATTGGTAACGTTTACAC	['ACAATT', 'ATACTT', 'ATATAC', 'ATGCTA', 'CTTAAA', 'TAACGT', 'TTAAAC']
TTTGTGGTGATCTACACTGATACTCTGTTGCATTATTCGCCTGAAACCACAATATTCAGGCGTTTTTTCGCTATCTTTGAC	['ACAATA', 'ACACTG', 'ATACTC', 'CACAAT', 'GATACT', 'TACACT']
GTTTCGTGCCGGTTGTGAAGAAAAAGTGAATGATGTAGCCGTCAAGTTGTCATAATTGGTAACGAATCAGACAATTGACGG	['ACAATT', 'ATAATT', 'CATAAT', 'GACAAT', 'TAATTG']
GTGTCGCTGACAAGTGAAGTTGTTTGATTATGATAACTTGATTGCAAAATATTATTAACAATTAAAGCAATTATGTTACAG	['ACAATT', 'ATGTTA', 'TATGAT', 'TATTAT', 'TTATGA']
ATTTCTCAAATTCTAAAAATCTCAACCAAACTTATCTGATAACACTAAATTCGAAAGAATGCGTACAGGTAAGTAACAATG	['AAACTT', 'ACAATG', 'ACACTA', 'CTAAAA', 'TCTAAA']
ATAACCAAATGCGATAACTCAGACGCTAAAGTTTTGCCACCCGGCTACCGTTATCAGTAGCAGAGACAATAACGTTAAGGA	['ACAATA', 'CGATAA', 'CGCTAA', 'CGTTAA', 'GACAAT', 'GCTAAA', 'TAACGT']
ACCGACACTTAAAGTGATCCAGATTACGGTAGAAATCCTCAAGCAGCATATGATCTCGGGTATTCGGTCGATGCAGGGGAT	['ACACTT', 'ATATGA', 'CTTAAA', 'GACACT', 'TATGAT']
TTGCTTGACCCGCAAATGGAAAGACAACTGGTGCTGGGATTATGATGTATACTATTATGTATATTCTGGTGTGCATTATTA	['GTATAC', 'TATATT', 'TATGAT', 'TATTAT', 'TATTCT', 'TGTATA', 'TTATGA']
AGGGGCTGGACGATTATATTTGTAAACGATTCAGCTTAAACTGCCCGGAAGCGAATCTGTCCGAATGGGAACAGGTTATCT	['CTTAAA', 'GCTTAA', 'TAAACT', 'TATATT', 'TTAAAC']
GGTTGTGCTTCATAGCCTTTCTCCTTGCCGGATGGCGGGTAAGAGGCTAAGATCTGAATTGCTAGGTTCATTCGTTGGCCT	['GCTAAG', 'GCTAGG', 'GGCTAA', 'TAGCCT', 'TGCTAG']
GTGATGGCGGGATCGTTGTATATTTCTTGACACCTTTTCGGCATCGCCCTAAAATTCGGCGTCCTCATATTGTGTGAGGAC	['AAAATT', 'CTAAAA', 'TAAAAT', 'TATATT', 'TGTATA']
GGTTTAATTACAGTTAACGAAAAGTTGTCATTTTTAACAACTGATATAGACTGCCGAATCATCTGCACATAATTACGATTC	['AGACTG', 'ATAATT', 'CATAAT', 'TACGAT', 'TAGACT']
AGATTTGTCACTTATTGGATTTAGTATGCTTGATTTAAATGGCGGACAATTATTGTTATTATTAAGTCTAATGTCATTTAA	['ACAATT', 'GACAAT', 'TAGTAT', 'TATTAT']
AAGTGTGACGCATATTGCTTTTGGTCATTATCTGCACAGTAAACGGTGGTATACTGTGCAGGTCTTGTCTAAAAGCGAGGA	['ATACTG', 'CTAAAA', 'GGTATA', 'GTATAC', 'TCTAAA']
TATGCAAAATTGTGGTAGATCTGTTACTTCCCCTCTACTATTCCCACGTTAAAATAGGGTGTTCCCTGGAAAGTTGCAGAT	['AAAATT', 'CGTTAA', 'CTGTTA', 'GTTAAA', 'TAAAAT', 'TAGGGT', 'TTAAAA']
ACTGACGGGCAGATCCTCGTGATGCACGACGCCTTTGGTATTACCGGCGGTCACATTCCTAAATTCGCTAAAAATTTCCTC	['AAAATT', 'CGCTAA', 'CTAAAA', 'GCTAAA']
CTGACTAAATAAAAATTTTTCACTAATTGATTAGTCATAGCCAGCGATATACGCTATGCGAAAATGCAGATGGCAATGAGA	['AAAATG', 'AAAATT', 'ATATAC', 'TAATTG', 'TACGCT']
ATTTACATGGTTGCTGTGTTGTTAAATTGTACAAAGATGTTATAGAAACAAAATGTAACATCTCTATGGACACGCACACGG	['AAAATG', 'ATGTTA', 'GTTAAA', 'TAACAT']
TACGAAAATGGCTCACCCGAAATATCATACTTCTGCCTTTAGCTCCGTCTCTATAATTTGGGAAAATTGTTTCTGAATGTT	['AAAATG', 'AAAATT', 'ATAATT', 'ATACTT', 'CATACT', 'CTATAA', 'TATAAT', 'TATCAT', 'TCTATA']
GATTTCCTTAATTGTGATGTGTATCGAAGTGTGTTGCGGAGTAGATGTTAGAATACTAACAAACTCGCAAGGTGAATTTTA	['AGAATA', 'ATGTTA', 'GTTAGA', 'TAATTG']
GTAACCAAATGCAGCAATACATTTGTTTTAGCAATACAATTGCTGCACACTATTCTAAAAGCCGCATAATATCTTAGCAAG	['ACAATT', 'ACACTA', 'CACACT', 'CATAAT', 'CTAAAA', 'TACAAT', 'TATTCT', 'TCTAAA']
ATAACCCGGAAGATCTTCACCTTCAGCCTGCCGGTAAAATTTATCTGGCTGAAACGCCGTGGTTTAACATCTCGGCGACCA	['AAAATT', 'GGTAAA', 'GTAAAA', 'TAAAAT', 'TAACAT']
AAATGTATTTCTTTTTCGCGCAATGGGTGATAGAAAATCGCTCCAAGTGATAATGCTTATCAAAATTATTATCACTTTCAC	['AAAATT', 'ATAATG', 'GATAAT', 'TAATGC', 'TATTAT']
AAGCGGTGGAGATCTTCTCTGCCGCTTTTTTTTTCATCAATCATCCCCATAATCCTTGTTAGATTATCAATTTTAAAAAAC	['ATAATC', 'CATAAT', 'GTTAGA', 'TAATCC', 'TAGATT', 'TTAAAA']
TTATACTCGGGCAAATATAAATTTGCAAAAAATGCGAAGATAATGTTTTTAATATTTTGAACAATATGGCATTGAATGATA	['AAAATG', 'AAGATA', 'ACAATA', 'AGATAA', 'ATAATG', 'ATACTC', 'GATAAT']
TCACCAGCAAGAAGTGAAAAAACTGTGAGTAAGCGGGTGATAAATGGTAAAAGTCATCTTGCTATAACAAGGCTTGCAGTG	['ATGGTA', 'CTATAA', 'GGTAAA', 'GTAAAA']
GGGGCCATCATGGGTCGAGTAGCGCTGAATATTGAAAATCATAGTTGCCTCTCTATTTCGTTCAAGCATTAAAATACTTTC	['ATACTT', 'ATAGTT', 'TAAAAT', 'TTAAAA']
TACCCGCGCAGTTAAGCGGGAAAACTATTTCGCAACGTCGCGCTTGTGGCTAAAATAGCCGCCATTTTTCAGCTACTGGAT	['CTAAAA', 'GCTAAA', 'GGCTAA', 'TAAAAT']
CCGCGTCTTTTCCCCGCTTTGTTGCGCTCAAGACGCAGGATAATTAGCCGATAAGCAGTAGCGACACAGGAAGACCGCAAC	['ATAATT', 'CGATAA', 'GATAAT', 'GGATAA']
TAAGTAGGGATTTATTCAAAATATTGCCATTTTTTCGTTTTATGCATGATAATGTAAAAGATATTAATATTTATAATTTAT	['AAGATA', 'ATAATG', 'ATAATT', 'GATAAT', 'GTAAAA', 'TATAAT']
GCAATAATTGAACGTTCGCGATTTTTGAAAGAAAACGGTCAATGGTACTATATTGACGGTACACGTCCGCAGTTTGGTCGC	['ATAATT', 'ATGGTA', 'TAATTG', 'TATATT']
ACACATCTGATTTCACTGTGAGCTGGAATGAACTTATAATGCGCTTCCAATACTCTAATATTCTCAACCCAATGGCCTGCC	['ATAATG', 'ATACTC', 'TAATGC', 'TATAAT', 'TATTCT']
GTTGTCTTTTGTTTCCGTAGGGTGTTGGCTTCAGGCTCCATGCCTGCGGCTGATTATGCCACTATAACCGTTAATTCCACA	['CGTTAA', 'CTATAA', 'TAATTC', 'TAGGGT']
ATTTTTTTCATAATAATGCCCTCAATTTAAAAACATAACTTATTGCGATATGGTTACATTAAGGGCAAAGCATCTCTAATG	['ATAATG', 'CATAAT', 'TAATGC', 'TTAAAA']
GGCGATTCAGTCACCTCAACCCCGACCAGTATAACGGCGCCTGTCTGTTAGGATTGCGCGGCACGGTGATAAAAAGTCATG	['AGTATA', 'CTGTTA', 'TAGGAT', 'TTAGGA']
TCTAAAAGAAGTTTTTTGCATGGTATTTTCAGAGATTATGAATTGCCGCATTATAGCCTAATAACGCGCATCTTTCATGAC	['ATGGTA', 'CTAAAA', 'TAGCCT', 'TCTAAA', 'TTATGA']
ATGTTAGCTATAGCATACAAAATCACTTGACCGATATGTTAGTCATGGCTAATCTTGTTTGCATCAACACACCGCACGGTG	['ATGTTA', 'GGCTAA', 'TAATCT', 'TAGCAT']
TGCTGCCGTTTATTTTCGTGATCCAGTTAAAGTAAATGCATTTACCTGCTACTTTTTAGTAAAAATTTTACTAAACTCCCC	['AAAATT', 'CTAAAC', 'GTAAAA', 'GTTAAA', 'TAAACT']
ATCTGTTAATAAAGCTCGAATTGTGATGACGATCACACATGTTAAAACCTATAATTAATTGCTACTAAAATATTAATGAAT	['ATAATT', 'ATGTTA', 'CCTATA', 'CTAAAA', 'CTATAA', 'CTGTTA', 'GTTAAA', 'TAAAAT', 'TAATTG', 'TATAAT', 'TTAAAA']
AATTCTGCGATGTGATATTGCTCTCCTATGGAGAATTAATTTCTCGCTAAAACTATGTCAACACAGTCACTTATCTTTTAG	['ACTATG', 'CGCTAA', 'CTAAAA', 'GCTAAA']
CGGATTGTATGGGCGTGATACTGAATTACATAACGTAAATTCTCACGCATAATAATTATTCGACGTTGCTAACGGGCCATT	['ATAATT', 'ATACTG', 'CATAAT', 'GATACT', 'TAACGT']
ATCTCTTTATGTGACTAACTTCACTTACATCCACTTATTTCTCTTCGTAAAATTACTTTGGAATTAAGTACAATAAGAAGA	['AAAATT', 'ACAATA', 'GTAAAA', 'TAAAAT', 'TACAAT']
AGTTACATTTAGTTACATGTTTAACACTTGATTTAAGATTTGTAATGGCTAGATTGAAATCAGATGTAATCCATTAGTTTT	['ACACTT', 'GCTAGA', 'GGCTAG', 'TAATCC', 'TAGATT']
CATAATACGCATAAAATAAGGCTTACGCAAAAATGGAACACATAAAAATATAATATGTTTTATCTGCAACCATAAGGAAAT	['AAAATG', 'CATAAT', 'TAAAAT', 'TATAAT']
AGAACCCGTCGGCATGGCGGGTTATTTGTCCTGGTTATTCCCCCGTTGTAAAATCTCTCCTAAACTTAACGGTACGGCACC	['AAACTT', 'CTAAAC', 'GTAAAA', 'TAAAAT', 'TAAACT']
ATCTTTCCATAACAAATGGTTATTCATTAATCCTGCCATAAACTCGCGTTATTATGCATTAATGCAGCGAAAAGCTCTGTT	['TAAACT', 'TAATCC', 'TAATGC', 'TATTAT']
AAGTGCCGCCACTATAGGTATTTGCTGGTAGAAGCTCAACGGACAATTTATAATGGCTCAGATTAAAAAAACTAATAGGTT	['ACAATT', 'ATAATG', 'GACAAT', 'TATAAT', 'TTAAAA']
AAGATATTCACCTTATTGCAAGATATTTAAAATGCTCTAGAGTTAAAAGTATGATGTAAAGACCATTGGCCTGGACAATTA	['AAAATG', 'AAGATA', 'ACAATT', 'GACAAT', 'GTTAAA', 'TAAAAT', 'TAGAGT', 'TATGAT', 'TTAAAA']
CTCGCGTTCTCCGCGGCGGATATCGTCGGCGTACCAGACGGTGTGTGGTATACTTACGGGGTTTTTCTTCATTGTATGGTC	['ATACTT', 'GGTATA', 'GTATAC', 'TATCGT']
CAAGAATAAGTTATCAATAACCAGTTTGTGATCTCTGAAGAATATTACTAAAGTTAAAATGTAATCCGATTTAAATATCGA	['AAAATG', 'AGAATA', 'GTTAAA', 'TAAAAT', 'TAATCC', 'TTAAAA']
TGGATATGTTCCCACACACGGGACATCTGGAATCGATGGTACTTTTCTCGCGCGTTAAATAGTTGCGATTTGCCGATTTCG	['ATAGTT', 'ATGGTA', 'CGTTAA', 'GTTAAA']
AGGCGGAAAAAACTGATCTGGGGGATGTAGAAACTCAAGGAAGTAGCTATAATGCGCCCCGCCTCCATGTAGCAATCGAGG	['ATAATG', 'CTATAA', 'TAATGC', 'TATAAT']
GCGGGGAGTAATCCCATAAGCGCTAACTTAAGGGTTGTGGTATTACGCCTGATATGATTTAACGTGCCGATGAATTACTCT	['ATATGA', 'CGCTAA', 'TAACGT', 'TAATCC', 'TATGAT']
TCCAACACGAGTTTTACTCCCTGTTTCAACAATCATCCTATTTTGCCATATCAGAAAAATAACATAGCGGTATAAATCAAC	['ACAATC', 'ATCCTA', 'GGTATA', 'TAACAT']
CAGAAAATTATTTTAAATTTCCTCTTGTCAGGCCGGAATAACTCCCTATAATGCGCCACCACTGACACGGAACAACGGCAA	['AAAATT', 'ATAATG', 'CCTATA', 'CTATAA', 'TAATGC', 'TATAAT']
GCAATAAAGTCGCCGTCGCCCGCGTTGAATTACACAATGAAGAACAGCTTTATATTGCCAGTGCCACCGCCACCTATATGG	['ACAATG', 'CACAAT', 'CCTATA', 'TATATT']
GGTGAACAATATTTAATGAAATTTTGAGAAAAGCCCGTTATGTTAACGGAAAATTATGTTAAAGCAGGAAATGTTATGGAA	['AAAATT', 'ACAATA', 'ATGTTA', 'GTTAAA']
TATTCAAAAAATGAAATAAGAATACATTGCTAAGTTATTCGCGCCTTTTTATAATTCGTTACCTTTCCAGGGACGCTAATC	['AAAATG', 'AGAATA', 'ATAATT', 'CGCTAA', 'GCTAAG', 'TAATTC', 'TATAAT']
TAACGGTTGGCTGTTCTTCGTTGCAAATGGCGACCCCCGTCACACTGTCTATACTTACATGTCTGTAAAGCGCGTTCTGCG	['ACACTG', 'ATACTT', 'CACACT', 'CTATAC', 'TCTATA']
ATGAAGCGAGCAAAAATTGCCCGCACCAGTTAAAGAAATTAGGGCGGGAGTATACTGCAAATGGCTGTTTTCGTCAGCAAC	['AAAATT', 'AGTATA', 'ATACTG', 'GAGTAT', 'GTATAC', 'GTTAAA']
GCATAATTAATGAGATTCAGATCACATATAAAGCCACAACGGGTTCGTAAACTGTTATCCCATTACATGATTATGAGGCAA	['ATAATT', 'CATAAT', 'CATATA', 'CTGTTA', 'TAAACT', 'TTATGA']
ACTGGCAGGAGTGCGAGTCTGCTCGCATAATCAACACTCATTCCTTGTGGTTTTAATTTTGCAACTATACTGTATATAAAA	['ATAATC', 'ATACTG', 'CATAAT', 'CTATAC', 'TGTATA']
GTTTGCGGAGGATGTTTGTGATCCTGTTTTGTAGTGCGATTAATCCGTGTACAATAACGCGCTATTTCTAATGCCTGAGGC	['ACAATA', 'TAATCC', 'TAATGC', 'TACAAT']
CGCCGCGAAAGCGTAACGTTTCTCATTGAAATTCACTACACTTAACCCCATGCTACACACATTATGTAAAGCGCCTGTTGA	['ACACTT', 'ATGCTA', 'TAACGT', 'TACACT']
ATTTGTTAAATTAGCGTGAACTCTGACGGTATAACGCAAACCGGGGAATATAATTAACTTAGCGTAAAGCTTTTGCTATCC	['ATAATT', 'GGTATA', 'GTTAAA', 'TATAAT']
CTTAATCGATATTTAGATAAACTAATTTTATAAAAAACACAAAATAAAATATCATATTTCAATGATTAGTAGTCCTTAAAT	['AGATAA', 'CTTAAA', 'TAAAAT', 'TAAACT', 'TATCAT']
TTTAGCAAATCAATACACTTCAGGGGGGTATTATTGTAGAGTTTCCCCATATGTTTCTATGGGATCCAGGAAATGACAATC	['ACAATC', 'ACACTT', 'GACAAT', 'TACACT', 'TAGAGT', 'TATTAT']
GCGATGTGTAACCTTTGTCACACTCCAGGCACCCCGCCCTGCCATGCTCTACACTTCCCAAACAACACCAGAGAAGGACCA	['ACACTT', 'CACACT', 'TAACCT', 'TACACT']
TTGTACAGAACATTTATTATAATCCTATTCAATTATAATAATCATGCCATTATTATATTTAAACACTAGAGAGTGTCGTTG	['ACACTA', 'ATAATC', 'ATCCTA', 'TAATCC', 'TATAAT', 'TATATT', 'TATTAT', 'TTAAAC']
CCGCCAACAATATAAGTTTTTATAAAATTAAATATAAGATTATGGCTTTAGAATATTTTTATTTCTAATAGACGAGATTTT	['AAAATT', 'ACAATA', 'AGAATA', 'TAAAAT']
GATAATTAGCCGTTGCTGTTAAACACTTCTCTTTTAGCGGCAATTTTTGCATTATTCATTTTCCCCCTTTTGCTATAAGGA	['ACACTT', 'ATAATT', 'CTATAA', 'CTGTTA', 'GATAAT', 'GTTAAA', 'TTAAAC']
AAGTTAATCATTATCAGGCCGAAATTGAATTGTATCCTGATAAAATTGCATTATCATTTTTATTCTTGAGTGGGTTTTCCC	['AAAATT', 'TAAAAT', 'TATCAT', 'TATCCT', 'TATTCT']
CAGGGTTATAGCGGCGAGGCGGCATGTTAAAACTCCAGATAGCTAACGAATCATAAGGTAGAAACATGCTACTCTGAACCG	['ATGCTA', 'ATGTTA', 'GTTAAA', 'TAAGGT', 'TTAAAA']
CCCGTCCCGTCTATAGTATTTATGAGGGTTTGCTTTTAATAATCATAATTACCCACCAGAGTGTGATATGCGTACAACCAT	['ATAATC', 'ATAATT', 'CATAAT', 'TAGTAT', 'TCTATA', 'TTATGA']
AAATCTGTGATTCAAACAGGTTATTTTGAAAGTAAACATCGGTTATGCGATAATCGCGCTAATGTGATGTAAAAAGATACA	['AAGATA', 'ATAATC', 'CGATAA', 'CGCTAA', 'GATAAT', 'GTAAAA']
AAAAGCAGAAATTTATCTGTTTCCCCCTTTAAAAATTCGGTGAATACCCTTACTTATTGGTATACTGAAGTTGCTTCAGAT	['AAAATT', 'ATACTG', 'GGTATA', 'GTATAC', 'TTAAAA']
CCGATGATCCTCATCGTAATCCAACCGAAACTTTACCTGATTCTGGCAGTCAAATCGGCTATCACAAAACAAGGATAAGGT	['AAACTT', 'GGATAA', 'TAAGGT', 'TAATCC']
CATTAGGGGTATTAATTTTAGTATTGATGGAAGGTGATTATTGAACAGTAACATCGAGTCACGGTAAAAATGTGAGGTATA	['AAAATG', 'GGTAAA', 'GGTATA', 'GTAAAA', 'TAACAT', 'TAGTAT']
GCATTATAGCCTAATAACGCGCATCTTTCATGACGGCAAACAATAGGGTAGTATTGACAAGCCAATTACAAATCATTAACA	['ACAATA', 'TAGCCT', 'TAGGGT', 'TAGTAT']
ATGGAACTCATCATAAATGAGACTTTTACCTTATGACAATCGGCGAGTAGTCTGCCTCTCATTCCAGAGACAGACAGAGGT	['ACAATC', 'GACAAT', 'TAGTCT', 'TTATGA']
TTTCCTGGAGTAAATAAATAACAATTAACAAGCATAATATTGCCATTGATAAAATAGCATGCCATAAAAGGACTTTTCAGG	['ACAATT', 'CATAAT', 'TAAAAT', 'TAGCAT']
GATGTTTGACGAGTATTTAACTTGTTATGAATAACATAGAATAGCAGCCATTCACTTTTTCTACGAATCAGGAACCCTCCA	['AGAATA', 'GAGTAT', 'TAACAT', 'TTATGA']
TTCGTTGCACGAACTGGAGCAGCTCCTGTGTAAACACTGATTGCCTCCCCCCCGTTGATGGGTAAAATAGCCGCAATTTTT	['ACACTG', 'GGTAAA', 'GTAAAA', 'TAAAAT']
AAAAGTCACGGCCTAATATGGCTAACAAACAATCAATTGTGATATAGTTCACAAAATTAATGAAACAAACAGAGTGTTTCA	['AAAATT', 'ACAATC', 'ATAGTT', 'GGCTAA']
AATGTTTTGGTAATAATCCTATAACACTGATGTTACCTGCTTAATCCAGCAATACCATGCCTGTCTGCTATGCTTTTTTGA	['ACACTG', 'ATAATC', 'ATCCTA', 'ATGTTA', 'CCTATA', 'CTATAA', 'GCTTAA', 'TAATCC', 'TACCAT']
CGAAGAGGAGGGATAATGAAAGTTTGTGGCACAGGTCATGTTCGGGTATACTGCTTTCCCGTCTTGGTTATTCCATCGTCT	['ATAATG', 'ATACTG', 'GATAAT', 'GGATAA', 'GGTATA', 'GTATAC']
AAAACAATTTTGAGGATTTCCTTATATTGGTGGTTAGTACGCATGCAATTAAAAATGAAATTCCGCGACCACAAGCCAAAA	['AAAATG', 'ACAATT', 'TATATT', 'TTAAAA']
GTCACATCATTGTAGTTAAAAAGGTTGAGTTAGATCGCAGAAACGGGTACATATAGCCCCGCAAACGTGACCACGCCCGCA	['CATATA', 'GTTAAA', 'GTTAGA', 'TTAAAA']
CTATGTGTTTATGAGGGAGAGGTATTTTCAGTTGATCTGGATTGTTAAATTCATATAATGCGCCTTTGCTCATGAATGGAT	['ATAATG', 'CATATA', 'GTTAAA', 'TAATGC', 'TATAAT', 'TTATGA']
AGTGGTCGGATGAGTAGTAAAATTACACAAAAGGCGGTACTATTTTCATCAGATAAACAAATTCATTTTTCCGGTGCCATT	['AAAATT', 'AGATAA', 'GTAAAA', 'TAAAAT']
TAACGTAAGTCGCAGAAAAAGCCCTTTACTTAGCTTAAAAAAGGCTAAACTATTTCCTGACTGTACTAACGGTTGAGTTGT	['CTAAAC', 'CTTAAA', 'GCTAAA', 'GCTTAA', 'GGCTAA', 'TAAACT', 'TAACGT', 'TTAAAA']
ATGAATGTATATTTCAAATTGATTTTGTTTGTTATTATTTAAGTGAGGTATATAATTAGAGTCCGTTATCAATGCTAAATA	['ATAATT', 'ATGCTA', 'GCTAAA', 'GGTATA', 'TAGAGT', 'TATAAT', 'TATATT', 'TATTAT', 'TGTATA']
AGATTCTTAAAATACAAACGTCGTATCCCTGAACGGATTGTTTTCTGTTAAGTTCAGGTTGTGAGCATAATTCGCCGGAGG	['ATAATT', 'CATAAT', 'CTGTTA', 'CTTAAA', 'TAAAAT', 'TAATTC', 'TTAAAA']
GTGAGAGTAATCACGCTTCTGCTTTTTAAAATTATTTGACAATACGAATATCACACTGTGATTACGATCACATTAGCAGTT	['AAAATT', 'ACAATA', 'ACACTG', 'CACACT', 'GACAAT', 'TAAAAT', 'TACGAT', 'TTAAAA']
ATAAATACACATTAGGTGATAGATTAACCTTCGCTATTTTCTCACTCTGTGTCGAATATATTTATTTCCTGAATAATTAAT	['ATAATT', 'TAACCT', 'TAGATT', 'TATATT']
GTGGGACGTTTCTGCGCACCTAAATCAATGACTAATGCCGATGGGTCAACTATACTTTTCACGAGTCTTTATGACCTCTCT	['ATACTT', 'CTATAC', 'TAATGC', 'TTATGA']
TTAATGAGTAGTCAAAATGACTATCAATCAAATGGTCGATATGACAATATCTATAGTCAAATTGACAGTGAGGCAAAGATG	['AAAATG', 'ACAATA', 'ATATGA', 'GACAAT', 'GACTAT', 'TCTATA']
AACGCTATCGACAACGATAAAGTCAGGTTGAAGTTGTGTATATCGGCTAAACTTAGGTTTAACAGAATGTAATGCCATGAC	['AAACTT', 'CGATAA', 'CTAAAC', 'GCTAAA', 'GGCTAA', 'TAAACT', 'TAATGC', 'TGTATA']
TCTTAAAGTTCAGTCTATTTAATGTTCAATGAAATATTTCTGCCTGTATAATCTTTAAAGATGTTGAACATATATTCACAT	['ATAATC', 'CATATA', 'CTTAAA', 'TAATCT', 'TATAAT', 'TATATT', 'TGTATA']
ACTCCCGGTACTTAAGTTGTAATTTTGTCATCGCAACAGCCCAATTATATATAATTTTATATATTACTATATAAATATGAA	['ATAATT', 'ATATGA', 'TATAAT', 'TATATT']
CAAAAAAAGCTCAAACATCCTTGATGCAAAGCACTATATATAGACTTTAAAATGCGTCCCAACCCAATATGTTGTATTAAT	['AAAATG', 'TAAAAT', 'TAGACT', 'TTAAAA']
AAATAGTGTCGCTGAGCACTAAAATTTAATGTAAATGGTGTGTTAAATCGATTGTGAATAACCAGCGCTTCCGGCAGGATA	['AAAATT', 'ATAGTG', 'CTAAAA', 'GTTAAA', 'TAAAAT']
TATAATTGTGAGTTTAATATTATGTTGACTCACTCATTGATCCAATACCTAACTTTACCAGCAACACCTCCGTCCCCAGTA	['ATAATT', 'TAATTG', 'TATAAT', 'TATTAT']
GATCGAGACATGTTTAAAAATGGCTTGCCATAATTAACGTTGTATGTGATAACAGATTTCGGGTTAAACGAGGTACAGTTC	['AAAATG', 'ATAATT', 'CATAAT', 'GTTAAA', 'TAACGT', 'TTAAAA', 'TTAAAC']
GTGCCTTTGTCAGCATAAAATAACGGCACAAAGGGCGGAATAATTCACTATCATTCAGGGGATTATGCTGGACATTTTTCA	['ATAATT', 'TAAAAT', 'TAATTC', 'TATCAT']
ACGAAAAAATGACAAATCCTTTTGCTGGTTAACCTGTGTACTGTCCTACACTTAATCTTTAAAAGATTGTGAGGGGCATAT	['AAAATG', 'ACACTT', 'TAACCT', 'TAATCT', 'TACACT', 'TTAAAA']
AAAGTCAGTTAATGTAATGCCTCCTACTGACCAAAGAATACTTGCACTTAAGGTTCAGTATAAAAGGGCATGATAATTTAC	['AGAATA', 'AGTATA', 'ATAATT', 'ATACTT', 'GATAAT', 'TAAGGT', 'TAATGC']
TCTTTCATGCCCCCTAATTTCACCTTTATCCCGCCCCTTAGACAGAATGTTATAATCTGAACCCACAACAGCGTTTGTACC	['ATAATC', 'ATGTTA', 'TAATCT', 'TATAAT']
AGTAATCAATTCAGGGTAATTGATGCTGGCGAAAAAAATCGAACAAGCTATAATTCAGCAACCATTTTACAGGTGGATGAA	['AAGCTA', 'ATAATT', 'CTATAA', 'TAATTC', 'TAATTG', 'TATAAT']
GACTATCATTTAATCTGGTGTCTCATTGTTAGCCGTCTGAAAATTCAATAACATCAAACTGTTTTGAATCTCTTTTCTTAT	['AAAATT', 'GACTAT', 'TAACAT', 'TAATCT', 'TATCAT']
GCTGGTAATCAAACAAAAAATATTTGCGCAAAGTATTTCCTTTGTCATAAAAATAATACTTCCAGACACTATGAAGTTGTG	['ACACTA', 'ACTATG', 'ATACTT', 'GACACT']
TCGACCATCTGATTTCATTAGTATCTTGAAAATCGGGTAATTACGACGCTAAATTAATGCAAGAATAAAAAACAGAGGAAC	['AGAATA', 'CGCTAA', 'GCTAAA', 'TAATGC', 'TAGTAT']
GCAAAAAAATATAGTTAGAATTTATTTGATAATCCGCTCACTTTTAACCTGATTTTTAAAACAACAACGCTTATTAAAAAA	['ATAATC', 'ATAGTT', 'GATAAT', 'GTTAGA', 'TAACCT', 'TAATCC', 'TTAAAA']
TCTTGTCATTTCCCCCCCATTTAGGCACAATGCGCCGCTGTCAAAAAATGACTAAAAACCGACGTTTCATCAGCGTCGGTT	['AAAATG', 'ACAATG', 'CACAAT', 'CTAAAA']
ATAATTGAAGTTTATATTTTACCTTTTGCAAATAATAAAATAACAAATTATAGTGACGCCACAGCAACAAATATAACCTTT	['ATAATT', 'ATAGTG', 'TAAAAT', 'TAACCT', 'TAATTG', 'TATATT']
CATTCCCCCGATATATGTTTATTTTATGTAAAATCAATTTATGTAAAAAGTCACATCATTGTAGTTAAAAAGGTTGAGTTA	['GTAAAA', 'GTTAAA', 'TAAAAT', 'TTAAAA']
AATAATAACCAACAGCTATAAATAAAGATTAAAAATATTTTCAGTGAATATAAAATTATTGCTGTTTCTATTAAAAAGATG	['AAAATT', 'CTATAA', 'TAAAAT', 'TTAAAA']
AAGCAATGAAATAATATATTCCAACAGTTGTTTTATATTCTCAAAATATGTTAAGGTTGCGCCCTCATTTGGGGAGTAGCC	['ATGTTA', 'TAAGGT', 'TATATT', 'TATTCT']
AGGGTTGTAATTGTGATCACGCCCGCACATAACCCACTGGGTGTTGTCTATACTTTACACATAAGGAAGAGGGGTATTCCC	['ATACTT', 'CTATAC', 'TAATTG', 'TCTATA']
CGCGGTAGTTATGATTAGATTGTTTTCGCAACAAAAACATTATGGATTATTATGCTGTGGTAAATGACTCATTCCACGGCA	['GGTAAA', 'TAGATT', 'TATGAT', 'TATTAT', 'TTATGA']
GTCATTACTCATAATATCTGCTAATGCTTTACATCTCCTTCGCGTTTGTATATTTTCTTTATCACTTGCAGAAATGCGGTG	['CATAAT', 'TAATGC', 'TATATT', 'TGTATA']
CATCATTATTACATCATCATTGTAAATAATTAAATTAACTTCCATAACATTAAAATATGTATCCACTGACGCTTTTTTACA	['ATAATT', 'TAAAAT', 'TAACAT', 'TTAAAA']
ATTTCCTGACTTATCTTCCATCTATCAAAAGTTTAAGACTGGACAATAATAAAATAACCCACATTGATACTAATAATACAT	['ACAATA', 'AGACTG', 'GACAAT', 'GATACT', 'TAAAAT']
TCTGGATCCGGCCTTTTGGCAAACTGATTTACCTGATGCCGCCCTATATTATTCTCCCGCAACAGTTGCAGCGTCTGACCG	['CCTATA', 'TATATT', 'TATTAT', 'TATTCT']
CAATCTTTGCGATTGGTCAGTGATGCTGTCAATCAGAGGGGGATTTGTCTAGAATAGAAGAAATAATCTTTCTAACTCCTG	['AGAATA', 'ATAATC', 'CTAGAA', 'TAATCT']
ATTTCATCATGATGTCTTTGATGAGCGGTGAACACAATACACTTGCGCTGTCTCTTCAGGATGAATCCCCTGGTCTGGTGC	['ACAATA', 'ACACTT', 'CACAAT', 'TACACT']
AGCAACGCCAGTCACAGGGATAATTTATGCGCTGCGTCACAAAAACTGCTACACTCCGCTCCCTCATGACATTGTGGTTTT	['ATAATT', 'GATAAT', 'GGATAA', 'TACACT']
TGTCAGCACTCTGACTTAACCGTGGATGCAAGTCTAAGCCTACGAAGATAAACTCTGTTTCGCAAGGTGACTATACCACAC	['AAGATA', 'AGATAA', 'CTAAGC', 'CTATAC', 'GACTAT', 'TAAACT']
ATTCGGAAATAAGATATGACCATTGCTGGTTAATTGAATAGCTCATTACACTCCATTAACACGATGTTGTAATTCGGCACA	['AAGATA', 'ATATGA', 'TAATTC', 'TAATTG', 'TACACT']
TTTCAGCTAACGGGCGCTCGAGAATAGGCGCAGAATCGACAAACGGTCTAAAATTCAGCGAAACACAATGTTGCTGAATCA	['AAAATT', 'ACAATG', 'AGAATA', 'CACAAT', 'CTAAAA', 'TAAAAT', 'TCTAAA']
GAGGCTAATGTTACCAGTTAAGATGCGCACTGAAAAACGGTTCTCTGTTAGACTTCAGAGAAACTCTCTACATTATGGCAC	['ATGTTA', 'CTGTTA', 'GGCTAA', 'GTTAGA', 'TAGACT']
